ACCESSION	PRESERVED_SPECIMEN
ADULTMOUNTED	PRESERVED_SPECIMEN
ADULTMOUNTED	PRESERVED_SPECIMEN
ADULTPAPERED	PRESERVED_SPECIMEN
ADULTPAPERED	PRESERVED_SPECIMEN
ALCOHOLMICROSCOPE	PRESERVED_SPECIMEN
COLLECTEDSPECIMEN	PRESERVED_SPECIMEN
COLLECTION	PRESERVED_SPECIMEN
DEADSEEDSAMPLE	PRESERVED_SPECIMEN
DRIEDSPECIMEN	PRESERVED_SPECIMEN
DRYSAMPLE	PRESERVED_SPECIMEN
ECIMEN	PRESERVED_SPECIMEN
ELECTRONICMEDIAPUBLISHEDREPORTSPECIMEN	PRESERVED_SPECIMEN
EMERGEDSPECIMEN	PRESERVED_SPECIMEN
ESPECE	PRESERVED_SPECIMEN
ESPECIMEN	PRESERVED_SPECIMEN
ESPECIMENPRESERVADO	PRESERVED_SPECIMEN
FISHPREPARATION	PRESERVED_SPECIMEN
FLUIDSPECIMEEN	PRESERVED_SPECIMEN
FLUIDSPECIMEN	PRESERVED_SPECIMEN
HERBARIUMSHEET	PRESERVED_SPECIMEN
HERBARIUMSPECIMEN	PRESERVED_SPECIMEN
LABEL	PRESERVED_SPECIMEN
MOUNTEDSPECIMEN	PRESERVED_SPECIMEN
MUSEUMSPECIMEN	PRESERVED_SPECIMEN
OBJEKT	PRESERVED_SPECIMEN
OTHERSPECIMEN	PRESERVED_SPECIMEN
PAPEREDSPECIMEN	PRESERVED_SPECIMEN
PHYSICALSPECIMEN	PRESERVED_SPECIMEN
PINNEDSPECIMEN	PRESERVED_SPECIMEN
PRESERVADO	PRESERVED_SPECIMEN
PRESERVE	PRESERVED_SPECIMEN
PRESERVED	PRESERVED_SPECIMEN
PRESERVEDINALCOHOL	PRESERVED_SPECIMEN
PRESERVEDRECORD	PRESERVED_SPECIMEN
PRESERVEDS	PRESERVED_SPECIMEN
PRESERVEDSMTS	PRESERVED_SPECIMEN
PRESERVEDSP	PRESERVED_SPECIMEN
PRESERVEDSPE	PRESERVED_SPECIMEN
PRESERVEDSPECI	PRESERVED_SPECIMEN
PRESERVEDSPECIERIFORMES	PRESERVED_SPECIMEN
PRESERVEDSPECIM	PRESERVED_SPECIMEN
PRESERVEDSPECIMEN	PRESERVED_SPECIMEN
PRESERVEDSPECIMENANSERIFORMES	PRESERVED_SPECIMEN
PRESERVEDSPECIMENSSERIFORMES	PRESERVED_SPECIMEN
PRESERVEDSPECUCOGASTER	PRESERVED_SPECIMEN
PRESERVEDSPECZONARIUSSEMITORQUATUS	PRESERVED_SPECIMEN
PRESERVEDSPVER	PRESERVED_SPECIMEN
PRSERVEDSPECIMEN	PRESERVED_SPECIMEN
PROKARYASPECIMEN:ARCHAEA	PRESERVED_SPECIMEN
PROKARYASPECIMEN:BACTERIA	PRESERVED_SPECIMEN
PS	PRESERVED_SPECIMEN
S	PRESERVED_SPECIMEN
SHEET	PRESERVED_SPECIMEN
SP	PRESERVED_SPECIMEN
SPECIMEN	PRESERVED_SPECIMEN
SPECIMENS	PRESERVED_SPECIMEN
SPECIMENSP	PRESERVED_SPECIMEN
SPECIMENUNPUBLISHEDREPORT	PRESERVED_SPECIMEN
VOUCHER	PRESERVED_SPECIMEN
VOUCHERREARED	PRESERVED_SPECIMEN
VOUCHERSPECIM	PRESERVED_SPECIMEN
VOUCHERSPECIMEN	PRESERVED_SPECIMEN
VOUCHERSPECIMENS	PRESERVED_SPECIMEN
VOUCHERSPIA	PRESERVED_SPECIMEN
VOUCHERVES	PRESERVED_SPECIMEN
	
SPECIMENSFOSSIL	FOSSIL_SPECIMEN
FOSSII	FOSSIL_SPECIMEN
FOSSIL	FOSSIL_SPECIMEN
FOSSILESPECIMEN	FOSSIL_SPECIMEN
FOSSILRECORD	FOSSIL_SPECIMEN
FOSSILSPECIMEN	FOSSIL_SPECIMEN
SPECIMENFOSSIL	FOSSIL_SPECIMEN
	
CULTURE	LIVING_SPECIMEN
ESPECIMENVIVO	LIVING_SPECIMEN
EXSICCATACULTIVATEDYES	LIVING_SPECIMEN
GERMPLASM	LIVING_SPECIMEN
GERMPLASMSEED	LIVING_SPECIMEN
GERMOPLASMSEED	LIVING_SPECIMEN
L	LIVING_SPECIMEN
LIVEPLANTCOLLECTION	LIVING_SPECIMEN
LIVING	LIVING_SPECIMEN
LIVINGBUTASYETNOTSOWNSEEDS	LIVING_SPECIMEN
LIVINGGROWINGPLANT	LIVING_SPECIMEN
LIVINGORGANISM	LIVING_SPECIMEN
LIVINGSPECIMAN	LIVING_SPECIMEN
LIVINGSPECIMEN	LIVING_SPECIMEN
SOWNBUTASYETNOTGERMINATEDSEEDS	LIVING_SPECIMEN
	
ENVIRONMENTSAMPLE	MATERIAL_SAMPLE
ENVIRONMENTALDNA	MATERIAL_SAMPLE
ENVIRONMENTALSAMPLE	MATERIAL_SAMPLE
GENOMICDNA	MATERIAL_SAMPLE
PRESERVEDTISSUE	MATERIAL_SAMPLE
SAMPLE	MATERIAL_SAMPLE
SOILSAMPLE	MATERIAL_SAMPLE
WATERSAMPLE	MATERIAL_SAMPLE
	
AUDIORECORDING	OBSERVATION
COMPOUNDOBSERVATION	OBSERVATION
DRAWING	OBSERVATION
DRAWINGORPHOTOGRAPH	OBSERVATION
FIELDSURVEY	OBSERVATION
FOTO	OBSERVATION
IMAGEN	OBSERVATION
IMAGENTIPO	OBSERVATION
LIVEOBSERVATION	OBSERVATION
MULTIMEDIAOBJECT	OBSERVATION
O	OBSERVATION
OBS	OBSERVATION
OBSERVACION	OBSERVATION
OBSERVADO	OBSERVATION
OBSERVASJON	OBSERVATION
OBSERVATION	OBSERVATION
OBSERVATIONS	OBSERVATION
OBSERVATIONUNPUBLISHEDREPORT	OBSERVATION
OBSFROMBOAT	OBSERVATION
OBSFROMCAR	OBSERVATION
PHOTO	OBSERVATION
PHOTOGRAPH	OBSERVATION
PRESENTONLYSEENORHEARD	OBSERVATION
SIGHT	OBSERVATION
SIGHTING	OBSERVATION
SO	OBSERVATION
SOUND	OBSERVATION
SOUNDRECORDING	OBSERVATION
STILLIMAGE	OBSERVATION
VIDEORECORDING	OBSERVATION
	
HO	HUMAN_OBSERVATION
HUMANOBSERVATION	HUMAN_OBSERVATION
HUMANOBSERVATION	HUMAN_OBSERVATION
OBSERVACIONHUMANA	HUMAN_OBSERVATION
	
OBSERVACIONCONMAQUINA	MACHINE_OBSERVATION
	
BOOK	MATERIAL_CITATION
JOURNAL	MATERIAL_CITATION
LIT	MATERIAL_CITATION
LITERATUR	MATERIAL_CITATION
LITERATURANGABE	MATERIAL_CITATION
LITERATURE	MATERIAL_CITATION
LITERATUREDATA	MATERIAL_CITATION
LITERATURERECORD	MATERIAL_CITATION
PUBLICATION	MATERIAL_CITATION
PUBLISHEDREPORT	MATERIAL_CITATION
REPORTADO	MATERIAL_CITATION
UNPUBLISHEDREPORT	MATERIAL_CITATION
LITERATUREOCCURRENCE	MATERIAL_CITATION
	
OCCURRENCE	OCCURRENCE
UNKNOWN	OCCURRENCE
