# A command used to sort this file:
# (sed -u 3q; LC_ALL=en_US.UTF-8 sort -t $'\t' -k1,1) < countryName.tsv
# Note the real (en_US) locale, which orders E→É→F
A	ZZ
AALST BELGIUM	BE
AALTER BELGIUM	BE
AÃORES	PT
ABDAL KURI I	YE
ABERDEEN SCOTLAND	GB
ABESSINIÃ	ZZ
ABESSYNIA	ZZ
ABIDJAN	CI
ABKHAZIA	GE
ABUARBI SHIGA PREF JAPAN	JP
ABU DHABI	AE
ABW	AW
ABYSINIA	ZZ
ABYSS	ZZ
ABYSSIANIA	ZZ
ABYSSIMIA	ZZ
ABYSSINA ETHIOPIA	ET
ABYSSINE ETHIOPIA	ET
ABYSSINIA	ZZ
ABYSSINIA ETHIOPIA	ET
ACE LAKE VESTFOLD HILLS ANTARCTICA	AQ
ACORES	PT
ACORES I	ZZ
ACT	ZZ
ADAMAN IS	IN
ADELAIDE IS	AQ
ADEN	YE
ADEN NOW YEMEN	YE
ADMIRALTY	ZZ
ADMIRALTY BAY KING GEORGE ISLAND SOUTH SHETLAND ISLANDS ANTARCTICA	AQ
ADMIRALTY GROUP	PG
ADMIRALTY I	ZZ
ADMIRALTY IS	ZZ
ADMIRALTY ISLANDS	PG
ADRIATIC	ZZ
ADRIATIC SEA	ZZ
ADRIATIQUE	ZZ
AEGEAN ISLANDS REGION	ZZ
AEGEAN SEA	ZZ
A E SUDAN	SD
A FEW MILES OFFSHORE OF LA SPEZIA ITALY	IT
AFG	AF
AFGANISTAN	AF
AFGANISTÁN	AF
AFGHANISTAN	AF
AFGHANISTAN CHINA USSR	ZZ
AFGHANISTAN INDIA KAZAKHSTAN PAKISTAN TURKMENISTAN UZBEKISTAN	ZZ
AFGHANISTAN IRAN PAKISTAN	ZZ
AFGHENISTAN	AF
AFR	ZZ
AFRICA	ZZ
AFRICA BY INFE	ZZ
AFRICA BY INFERENCE	ZZ
AFRICA CAMEROON	CM
AFRICA CAMEROONS	CM
AFRICA CAMEROUN	CM
AFRICA CENTRAL	ZZ
AFRICA E	ZZ
AFRICA EAST	ZZ
AFRICA EUROPE	ZZ
AFRICA KWAZULU	ZA
AFRICAN COUNTRIES	ZZ
AFRICA NORTH	ZZ
AFRICA S E	ZZ
AFRICA SW	ZZ
AFRICA W	ZZ
AFRICA W CAMEROON	CM
AFRICA WEST	ZZ
AFRICA ZIMBABWE	ZW
AFRIDA	ZZ
AFRIKA K	ZZ
AFRIKA TANGANYIKA LAND	TZ
AFRIQUE	ZZ
AFRIQUE AUSTRALE	ZA
AFRIQUE DU NORD	ZZ
AFRIQUE DU SUD	ZA
AFRIQUE DU SUD BANTU	ZA
AFRIQUE DU SUD BASUTOLAND SOTHO	ZA
AFRIQUE DU SUD BOTSWANA KGATHA	BW
AFRIQUE DU SUD LOBEDU	ZA
AFRIQUE DU SUD MFENGU	ZA
AFRIQUE DU SUD MPONDOZULU LALA	ZA
AFRIQUE DU SUD PAYS VENDA	ZA
AFRIQUE DU SUD SOTHO	ZA
AFRIQUE DU SUD SOTHO DU BASUTOLAND	ZA
AFRIQUE DU SUD SOTHO LOBEDU ZULU	ZA
AFRIQUE DU SUD SOTHO NGUNI	ZA
AFRIQUE DU SUD SWAZILANDSWATI	ZA
AFRIQUE DU SUD TRANSVAAL ORIENTAL	ZA
AFRIQUE DU SUD XHOSA	ZA
AFRIQUE DU SUD XHOSA ET MFENGU	ZA
AFRIQUE DU SUD ZIMBABWE NDEBELE	ZW
AFRIQUE DU SUD ZULU	ZA
AFRIQUE DU SUD ZULU KWENA	ZA
AFRIQUE DU SUD ZULU SWATI	ZA
AFRIQUE OCCIDENTALE	ZZ
AFRIQUE ORIENTALE	ZZ
AFRIQUE ORIENTALE ANGLAISE	KE
AFRIQUE SUD	ZA
AFRIQUE SUD ET EST GUINÃE CONAKRY FOUTADJALLON	GN
AFRX	ZZ
AGALEGA IDS	MU
AGELEGA ISLANDS	MU
AGO	AO
AIA	AI
AICHI JAPAN	JP
AIN	ZZ
AISNE FRANCE	FR
AJUY ILTOILO PHILIPPINES	PH
AK	US
AKABA	JO
ALA	AX
ALABAMA	US
ALABAMA USA	US
ALAGOAS BRAZIL	BR
ÅLAND	AX
ÅLAND ÎLES	AX
ALASKA	US
ALASKA BEARING SEA	US
ALASKA PANAMA BAHAMAS	ZZ
ALASKA TO SOUTHERN UNITED STATES	ZZ
ALASKA USA	US
ALASKA U S A	US
ALB	AL
ALBANIA	AL
ALBANIE	AL
ALBANIO	AL
ALBERTA	CA
ALBERTON SOUTH AFRICA	ZA
ALBUQUERQUE CAY	CO
ALBUQUERQUE KEY	CO
ALDABRA	SC
ALDABRA ATOLL	SC
ALDABRA ATOLL INDIAN OCEAN	SC
ALDABRA I	SC
ALDABRA IS	SC
ALDABRA ISLAND	SC
ALDABRA ISLANDS	SC
ALDABRAR IS	SC
ALDERLEY BRISBANE AUSTRALIA	AU
ALEMANHA	DE
ALEMANIA	DE
ALEMANYA	DE
ALEUTIAN IS	US
ALEUTIAN ISL	US
ALEUTIAN ISLANDS	US
ALEXANDER ARCH	US
ALEXANDRIA EGYPT	EG
ALG	DZ
ALGERIA	DZ
ALGERIÃ	DZ
ALGÈRIA	DZ
ALGERIA MOROCCO	ZZ
ALGERIA N	DZ
ALGERIAN SAHARA	DZ
ALGERIA OR TUNIS	ZZ
ALGERIA TUNISIA	ZZ
ALGERIA W MOROCCO	ZZ
ALGERIE	DZ
ALGÉRIE	DZ
ALGÉRIE OU TUNISIE	ZZ
ALGER MAROCCO BORDER	ZZ
ALGIERS	DZ
ALICANTE SPAIN	ES
AL-JAZĀ'IR	DZ
ALLEMAGNE	DE
ALLEMAGNE GERMANY DEUTSCHLAND	DE
ALLEMAGNE OU RUSSIE	ZZ
ALL LOCALITY DA	ZZ
ALOFA I	ID
ALOR I	ID
ALORI I	ID
ALOR IS	ID
ALOV I	ID
ALPINE INDIA	IN
ALTAI	RU
AMAKUSA NAGASAKI PREF JAPAN	JP
AMALIAS GREECE	GR
AMAZON	ZZ
AMAZON BASIN	ZZ
AMAZONIAN BRAZIL	BR
AMAZONS	ZZ
AMAZONS OF PERU	PE
AMAZONS UPPER	ZZ
AMAZON VALLEY	ZZ
AMBOINA	ID
AMBON I	ID
AMER	ZZ
AMERICA	ZZ
AMERICANSAMOA	AS
AMERICAN SAMOA	AS
AMERICAN SAMOA I	AS
AMERICAN SAMOA OR SAMOA	ZZ
AMERICAN SAMOA USA	AS
AMERICA PACIFIC OCEAN	ZZ
AMERICA U S A	US
AMERIKA	ZZ
AMERIQUE	ZZ
AMÉRIQUE	ZZ
AMERIQUE CENTRALE	ZZ
AMÉRIQUE CENTRALE OU DU SUD	ZZ
AMÉRIQUE DU NORD	ZZ
AMERIQUE DU SUD	ZZ
AMÉRIQUE DU SUD	ZZ
AMÉRIQUE MÉRIDIONALE	ZZ
AMERIQUE SEPTENTRIONALE	ZZ
AMÉRIQUE TROPICALE	ZZ
AMER SAMOA	AS
AMIRANTES	SC
AMPONVILLE FRANCE	FR
AMSAMOA	AS
AM SAMOA	AS
AMST	NL
AMSTERDAM	NL
AMSTERDAM I	ZZ
AMSTERDAM ISLAND	ZZ
AMSTERDAM THE NETHERLANDS	NL
AMUR	RU
AMURLAND	RU
ANATOLIA	ZZ
AND	AD
ANDAMAN AND NICOBAR	IN
ANDAMAN AND NICOBAR IS	IN
ANDAMAN AND NICOBAR ISLANDS	IN
ANDAMAN I	IN
ANDAMAN IS	IN
ANDAMAN ISL	ZZ
ANDAMAN ISLANDS	IN
ANDAMANS	IN
ANDAMAN S	IN
ANDAMAN SEA	ZZ
ANDES OF VENEZ	VE
ANDES OF VENEZUELA	VE
ANDES OF VENEZUELA MERIDA	VE
ANDORRA	AD
ANDORRE	AD
ANG	AO
ANGIGUA	AG
ANGLETERRE	GB
ANGLO EGYPTIAN SUDAN	ZZ
ANGLO E SUDAN	ZZ
ANGLO SUDAN	ZZ
ANGOLA	AO
ANGOLA BORDER	AO
ANGOLA CONGO	ZZ
ANGOLA EXCLAVE	AO
ANGOLA NAMIBIA SOUTH AFRICA	ZZ
ANGOLA PORTUGUESE EAST AFR	AO
ANGOLA S LEONE	ZZ
ANGUILA	AI
ANGUILLA	AI
ANIRANTZ ISLANDS	ZZ
ANNAM	ZZ
ANNAN	ZZ
ANNOBON	GQ
ANNOBON I	GQ
ANT	ZZ
ANTACTICA	AQ
ANTAGUA	AG
ANTARCTIC	AQ
ANTARCTICA	AQ
ANTARCTICA AND ADJACENT ISLANDS	AQ
ANTARCTICA ÂS	AQ
ANTARCTIC ANTARCTICA	AQ
ANTARCTICA::TEXT	AQ
ANTARCTIC CIRCLE	AQ
ANTARCTIC OCEAN	AQ
ANTARCTIC PEINSULA	AQ
ANTARCTIC PENINS	AQ
ANTARCTIC PENINSULA	AQ
ANTARCTIC SEAS	ZZ
ANTARCTIC TERRITORY	AQ
ANTARCTIQUE	AQ
ANTARCTIS	AQ
ANTARTICA	AQ
ANTÁRTIDA	AQ
ANTIGUA	AG
ANTIGUA AND BARABU	AG
ANTIGUA AND BARBUDA	AG
ANTIGUA AND BARBUDA ANTIGUA	AG
ANTIGUA BARB	AG
ANTIGUA BARBADOS EXPEDITION	ZZ
ANTIGUA BARBUDA	AG
ANTIGUA BERMUDA	AG
ANTIGUA ET BARBUDA	AG
ANTIGUA IS	AG
ANTIGUA ISLAND	AG
ANTIGUA Y BARBUDA	AG
ANTILLAS NEERLANDESAS	ZZ
ANTILLES	ZZ
ANTILLES FRANÇAISES	ZZ
ANTILLES NÉERLANDAISES	ZZ
ANTIPODES IS	NZ
ANTIPODES I S E OF NEW ZEALAND	NZ
ANTIPODES ISLAND	NZ
ANTIPODES ISLANDS NEW ZEALAND	NZ
ANTIQUA	AG
ANTWERP BELGIUM	BE
ANTWERPEN BELGIUM	BE
ANTX	ZZ
APARRI CAGAYAN PHILIPPINES	PH
APPALACHICOLA BAY TALLAHASSEE	US
ARABIA	ZZ
ARABIA IRAG	ZZ
ARABIAN PENINSULA	ZZ
ARABIAN SEA	ZZ
ARABIA SAUDITA	SA
ARABIE	ZZ
ARABIE DU SUD	ZZ
ARABIE SAOUDITE	SA
ARAB REPUBLIC OF EGYPT	EG
ARAFURA SEA	ZZ
ARALO CASPIA	ZZ
ARCHIPELAGO	ZZ
ARCHIPEL DES MARQUISES	PF
ARCHIPEL DES SALOMON	SB
ARCHIPEL DES SEYCHELLES	SC
ARCHIPEL DES TONGA	TO
ARCHIPEL DES TUAMOTU	PF
ARCHIPEL DU VANUATU	VU
ARCTIC	ZZ
ARCTIC AMERICA	ZZ
ARCTIC AMERICA TO MEXICO	ZZ
ARCTIC CANADA	CA
ARCTIC COAST	ZZ
ARCTIC OCEAN	ZZ
ARCTIC SEA	ZZ
ARCTIC SEAS	ZZ
ARDÃCHE FRANCE	FR
ARDENNES BELGIUM	BE
ARE	AE
ÃREBRO SWEDEN	SE
AREE IS	ZZ
ARG	AR
ARGE	AR
ARGELIA	DZ
ARGEN	AR
ARGENT	AR
ARGENTANIÃ	AR
ARGENTIÃ	AR
ARGENTINA	AR
ARGENTINA BRAZIL	ZZ
ARGENTINA BRAZIL PARAGUAY	ZZ
ARGENTINA BRAZIL URUGUAY	ZZ
ARGENTINA CHILE	ZZ
ARGENTINA OR COLOMBIA	ZZ
ARGENTINA OR URAGUAY	ZZ
ARGENTINA OR URUGUAY	ZZ
ARGENTINA PATAGONIA	AR
ARGENTINA URUGUAY	ZZ
ARGENTINE	AR
ARGENTINE CHILI	ZZ
ARGENTINE GUATEMALA	ZZ
ARGENTINE OU URUGUAY	ZZ
ARGENTINE REP	AR
ARGENTINE REPUBLIC	AR
ARGENTINE REPUBLIC ARGENTINA	AR
ARGENTINIA	AR
ARGENTINIEN	AR
ARGENT REP	AR
ARGETON BRITTANY FRANCE	FR
ARG REP	AR
ARHUS DENMARK	DK
ARIZONA	US
ARIZONA USA	US
ARKANSAS	US
ARKANSAS USA	US
ARM	AM
ARMENIA	AM
ARMENIA AZERBAIJAN GEORGIA	ZZ
ARMENIA AZERBAIJAN GEORGIA RUSSIA	ZZ
ARMENIA RUSSIA	AM
ARMENIE	AM
ARMÉNIE	AM
ARMENIYA	AM
ARROW I	ZZ
ARROWSMITH BANK	MX
ARTIC CANADA	CA
ARU	ID
ARUBA	AW
ARUBA ISLAND	AW
ARU I	ID
ARU IS	ID
ARU ISLAND	ID
ARU ISLANDS	ID
ARY IS	ZZ
ASCENSION	ZZ
ASCENSION I	ZZ
ASCENSION ID	ZZ
ASCENSION ISLAND	ZZ
ASCENSION ISLANDS	ZZ
ASCHAFFENBURG GERMANY	DE
ASERBSSR	AZ
ASHBURTON NEW ZEALAND	NZ
ASHMORE AND CARTIER ISLANDS	AU
ASIA	ZZ
ASIA BY INFERE	ZZ
ASIA BY INFERENCE	ZZ
ASIA BY INFERERENCE	ZZ
ASIA EUROPE	ZZ
ASIA MINOR	ZZ
ASIA MINOR TURKEY	TR
ASIA SOUTH	ZZ
ASIA SW	ZZ
ASIATIC RUSSIA	RU
ASIATIC TURKEY	TR
ASIE	ZZ
ASIE INDO GANGETIQUE	ZZ
ASIEN	ZZ
ASIX	ZZ
ASM	AS
ASSAM	IN
ASSASSI	ZZ
ASSE BELGIUM	BE
ASSUMPTION	ZZ
ÃSTERREICH	AT
ÃSTERSUND SWEDEN	SE
ASTORP SWEDEN	SE
ASTRIA	AT
ATA	AQ
ATAPUPU	ID
ATF	TF
ATG	AG
ATLANTA USA	US
ATLANTIC	ZZ
ATLANTIC ISLANDS	ZZ
ATLANTIC O	ZZ
ATLANTIC OCEAN	ZZ
ATLANTIC OR SOUTH INDIAN OCEAN	ZZ
ATLANTIC STATES	US
AT SEA OFF N AFRICA	ZZ
ATSUGISHI KANAGAWA JAPAN	JP
ATSUMA HOKKAIDO JAPAN	JP
AU CF	AU
AUCKLAND I	NZ
AUCKLAND IS	NZ
AUCKLAND ISLAND	NZ
AUCKLAND ISLAND NEW ZEALAND	NZ
AUCKLAND ISLANDS	NZ
AUCKLAND I S OF NEW ZEALAND	NZ
AUCKLANDS	NZ
AUDE FRANCE	FR
AUGUSTA USA	US
AUGUSTUS I	ZZ
AUNUU ISLAND	AS
AUS	AU
AUS AA	ZZ
AUS HI	ZZ
AUS MI	ZZ
AUS NI	ZZ
AUST	ZZ
AUSTALIA	AU
AUSTEVOLL NORWAY	NO
AUST HUNGARY	ZZ
AUST NEW GUINEA	ZZ
AUSTR	ZZ
AUSTRAILIA	AU
AUSTRALASIA	AU
AUSTRALES I	AU
AUSTRALIA	AU
AUSTRÀLIA	AU
AUSTRALIA AND MELANESIA	ZZ
AUSTRALIA AND NEW GUINEA	ZZ
AUSTRALIA AND TASMANIA	AU
AUSTRALIA CAPTIVE	AU
AUSTRALIA COUNTRY	AU
AUSTRALIA E	AU
AUSTRALIA EASTERN	AU
AUSTRALIA INDONESIA PAPUA NEW GUINEA	ZZ
AUSTRALIAN ANTARCTIC DIVISION	AQ
AUSTRALIA NEW GUINEA	ZZ
AUSTRALIA NEW ZEALAND	ZZ
AUSTRALIA NORTHERN TERRITORY	AU
AUSTRALIA N W	AU
AUSTRALIA ORTASMANIA	AU
AUSTRALIA S	AU
AUSTRALIA SOUTH	AU
AUSTRALIA TONGA IS	ZZ
AUSTRALIA WA	AU
AUSTRALIE	AU
AUSTRAL IS	PF
AUSTRAL ISLAND	PF
AUSTRAL ISLANDS	PF
AUSTRAL ISLES	PF
AUSTRIA	AT
AUSTRIA HUNGARY	ZZ
AUSTRIA TSJECHIË	AT
AUSX	ZZ
AUT	AT
AUTRICHE	AT
AVES ISLAND	ZZ
AVGANISTAN	AF
AVIAN UK	GB
AYRSHIRE SCOTLAND	GB
AZE	AZ
AZERBAÏDJAN	AZ
AZERBAIDZHAN	AZ
AZERBAIJAN	AZ
AZERBAIJAN GEORGIA RUSSIA	ZZ
AZERBAIYÁN	AZ
AZERBAJDZAN	AZ
AZERBAYDZHAN	AZ
AZORE IDS	PT
AZORE IS	PT
AZORERNA	PT
AZORES	PT
AZORES ARCHIPELAGO PORTUGAL	PT
AZORES I	PT
AZORES IS	PT
AZORES ISLANDS	PT
AZORES (PORTUGAL)	PT
BADEN WURTTEMBERG GERMANY	DE
BAFFINLAND	CA
BAFFIN LAND	CA
B AFRICA	ZZ
BAH	BS
BAHA	BS
BAHAMA	BS
BAHAMA I	BS
BAHAMA ID	BS
BAHAMA IDS	BS
BAHAMA IS	BS
BAHAMA ISLAND	BS
BAHAMA ISLANDS	BS
BAHAMA ISLAND S	BS
BAHAMAS	BS
BAHAMAS I	BS
BAHAMAS IDS	BS
BAHAMAS IS	BS
BAHAMAS ISLANDS	BS
BAHAMAS RUSSELS ISL	BS
BAHAMAS THE	BS
BAHAMAS WEST INDIES	BS
BAHAMES	BS
BAHIA BRAZIL	BR
BAHRAIN	BH
BAHREIN	BH
BAHREÏN	BH
BAHRÉIN	BH
BAHREIN ISLAND	BH
BAJA CALIFORNIA	MX
BAKER ID	ZZ
BAKER IS	ZZ
BAKER ISLAND	ZZ
BALABAR I	PH
BALCARIC IS	ES
BALEARES	ES
BALEARES I	ES
BALEARIC	ES
BALEARIC IS	ES
BALEARIC ISL	ES
BALEARIC ISLANDS	ES
BALEARIC ISLES	ES
BALEARICS	ES
BALEARICS IS	ES
BALEARIE IS	ES
BALEARIS IS	ES
BALI	ID
BALI I	ID
BALI IS	ID
BALINGKAWAYAN SAN JOSE TARLAC TARLAC PHILIPPINES	PH
BALI OR LOMBOK	ID
BALKAN STATES	ZZ
BALLEARIC IS	ES
BALTIC SEA	ZZ
BALTIMORE USA	US
BALUCHIETAN PERSIA	ZZ
BALUCHISTAN	ZZ
BALUCHISTAN PERSIA	ZZ
BALUCHISTAN PERSIAN	ZZ
BALUCHISTON PERSIA	ZZ
BAM	BS
BAMBERG GERMANY	DE
BANAUE SIK IFUGAO PHILIPPINES	PH
BANDA IS	ID
BANDA I S	ID
BANDOENG INDONESIA	ID
BANGALADESH	BD
BANGGAAI I	ID
BANGGAAI IS	ID
BANGGAI	ID
BANGGAI IS	ID
BANGLADESH	BD
BANGLADESH INDIA	ZZ
BANGLADESH INDIA OR NEPAL	ZZ
BANGLEDESH	BD
BANGOR UK	GB
BÃNIN	BJ
BÃNIN MONO	BJ
BANKA I	ID
BANKS GR	VU
BANKS GROUP	VU
BANKS IS	ZZ
BANQUEREAU	CA
BANTUG MUNOZ NUEVA ECIJA PHILIPPINES	PH
BARBADE	BB
BARBADES	BB
BARBADO	BB
BARBADOES	BB
BARBADOES BARBADOS	BB
BARBADOS	BB
BARBADOS ANTIGUA	BB
BARBADOS B W I	BB
BARBADOS ISLAND	BB
BARBADOS WEST INDIES	BB
BARBUDA	AG
BARBUDA ISLAND	AG
BARENT S SEA	ZZ
BARENTS SEA	ZZ
BAROTSELAND	ZM
BARROW ALASKA	US
BARROW, ALASKA	US
BARZIL	BR
BASILAN I	PH
BASILAN ISLAND	PH
BASS STRAITS	AU
BASUTOLAND	LS
BATAM I	ID
BATAN ISLAND	PH
BATANTA IS	ID
BATAVIA	ID
BATH KENTUCKY UNITED STATES	US
BATJAN IS	ID
BATU I	ID
BATU ISLANDS	ID
BAVARIA	DE
BAWANA NEAR DELHI INDIA	IN
BAY	ZZ
BAYERN	DE
BAY OF BENGAL	ZZ
BAY OF FUNDY	CA
BAY OF PANAMA	PA
BAZIL	BR
B BAY OF BENGAL	ZZ
B BECHUANALAND	BW
B BURMAH	MM
B C	ZZ
B C AFRICA	MW
B CAMEROONS	CM
B CENTR AFRICA	MW
B CON	CG
B CONGO	CD
BDI	BI
B E A BRITISH EAST AFRICA KENYA	KE
B E AFR	KE
B E AFRICA	KE
B E AFRICA KENYA COLONY	KE
BE AFRICA UGANDA	UG
B E A KENYA COLONY	KE
BEARING SEA	ZZ
BEAR ISLAND	ZZ
BEAUFORT SEA	ZZ
BEAUNE FRANCE	FR
BECHUANALAND	BW
BECHUANALAND PROT	BW
BECHUANALAND PROTECTORATE	BW
BECQUEVOORT BELGIUM	BE
BEDFORDSHIRE UK	GB
BEERNEM BELGIUM	BE
BEERSE BELGIUM	BE
BEHRANG MALAYSIA	MY
BEIJING CHINA	CN
BEIRUT	LB
BEL	BE
BELA	BY
BELARUS	BY
BÉLARUS	BY
BELAU	PW
BELAU PALAU	PW
BEL C	CD
BEL CON	CD
BEL CONGO	CD
BELEARIC IS	ES
BELEP IS	NC
BELFAST EASTERN TRANSVAAL SOUTH AFRICA	ZA
BELG	BE
BELG CON	CD
BELG CONGO	CD
BELG CONGO FREE STATE	CD
BELGIA (BE)
BELGIAM CONGO	CD
BELGIAN	ZZ
BELGIAN CONGO	CD
BELGIAN CONGO N RHODESIA	ZZ
BELGIAN CONGO OR ANGOLA	ZZ
BELGIAN CONGO OR ZAIRE	ZZ
BELGIAN RUANDA	ZZ
BELGIANRUANDA URUNDI	ZZ
BÉLGICA	BE
BÈLGICA	BE
BELGIË	BE
BELGIEN	BE
BELGIQUE	BE
BELGIQUE BELGIË BELGIUM	BE
BELGIQUE BELGIË BELGIUM BELGIEN	BE
BELGIUM	BE
BELGIUM AALTER	BE
BELGIUM AMYLUM	BE
BELGIUM BELGIË BELGIQUE	BE
BELGIUM BELGIE BELGIQUE BELGIEN	BE
BELGIUM BELGIË BELGIQUE BELGIEN	BE
BELGIUM, CAMPINE REGION	BE
BELGIUM CONGO	CD
BELGUIM	BE
BELICE	BZ
BELIZE	BZ
BÉLIZE	BZ
BELIZE BRITISH HONDURAS	BZ
BELLE GLADE FLORIDA USA	US
BELUCHISTAN	ZZ
BELUDSCHISTAN	PK
BEN	BJ
BENG	ZZ
BENGAL	ZZ
BENGALE	ZZ
BENGLADESH	BD
BENIM	BJ
BENIN	BJ
BENÍN	BJ
BÉNIN	BJ
BÉNIN OU GUINÉE	ZZ
BÉNIN OU TOGO	ZZ
BENIN REPUBLIC	BJ
BÉNIN TOGO	ZZ
BENTAM	ZZ
BERING I	RU
BERING ID	RU
BERING INSLANDS	RU
BERING IS	RU
BERING ISLAND	RU
BERING SEA	ZZ
BERING STRAIT	ZZ
BERING STRAITS	ZZ
BERKELEY CALIFORNIA USA	US
BERKELEY USA	US
BERLINBUCH GERMANY	DE
BERMUDA	BM
BERMUDA IDS	BM
BERMUDA IS	BM
BERMUDA ISLANDS	BM
BERMUDA ISLAND S	BM
BERMUDA ISLANDS BRITISH	BM
BERMUDAS	BM
BERMUDAS WEST INDIES	BM
BERMUDA WEST INDIES	BM
BERMUDES	BM
BERMUDES I	BM
BERNE SWITZERLAND	CH
BERNUDA	BM
BES	BQ
BETHLEHEM USA	US
BETW CELEBES SULA IS	ID
BETWEEN CELEBES AND FLORES ISLANDS	ID
BETWEEN CELEBES FLORES IS	ID
BETWEEN FLORES AND CELEBES	ID
BETWEEN GREENLAND AND JAN MAYEN	ZZ
BETWEEN INDIA AND CEYLON	ZZ
BETWEEN INDIA AND CEYLON SRI LANKA	ZZ
BETWEEN MOZAMBIQUE BRIT CENT AFRICA	ZZ
BETWEEN NEW ZEALAND AND AUSTRALIA	ZZ
BFA	BF
B G	ZZ
BGD	BD
BGR	BG
B GUIANA	GY
B HONDURAS	BZ
BHOUTAN	BT
BHR	BH
BHS	BS
BHUTAN	BT
BHUTAN CHINA INDIA NEPAL PAKISTAN	ZZ
BHUTAN INDIA	ZZ
BHUTAN INDIA NEPAL PAKISTAN	ZZ
BIAK I	ID
BIELORRUSIA	BY
BIÉLORUSSIE	BY
BIH	BA
BIKINI ATOL	MH
BIKINI ATOLL	MH
BIKINI ID	MH
BIMINI	BS
BIMINI IS	BS
BIMINI ISLAND	BS
BINH THANH VIETNAM	VN
BINUNGKU I	ZZ
BIOKO	GQ
BIRMANIA	MM
BIRMANIE	MM
BISMARCK ARCH	PG
BISMARCK ARCHIP	PG
BISMARCK ARCHIPELAGO	PG
BISMARCK IS	PG
BISMARK ARCH	PG
BISMARK ARCHEPELAGO	PG
BISMARK ARCHIP	PG
BISMARK ARCHIPELAGO	PG
BISMARK IS	PG
BLACKPOOL UK	GB
BLACKSBURG USA	US
BLACK SEA	ZZ
BLACK SEA OR CASPIAN SEA	ZZ
BLACK SEA RUSSIA	RU
BLANK	ZZ
BLANKVANN NORWAY	NO
BLELHAM TARN UK	GB
BLM	BL
BLR	BY
BLZ	BZ
BMU	BM
B N GUINEA	PG
BNIN	BJ
BODENSEE	ZZ
BOEKHOUT BELGIUM	BE
BOFFIN LAND	CA
BOGOR INDONESIA	ID
BOGOTA	CO
BOHEMIA	CZ
BOHEMIA CZECHOSLOVAKIA	CZ
BOKHARA	UZ
BOL	BO
BOLI	BO
BOLIV	BO
BOLIVA	BO
BOLIVAR	BO
BOLIVARIAN REPUBLIC OF VENEZUELA	VE
BOLIVIA	BO
BOLÍVIA	BO
BOLIVIA BRAZIL	ZZ
BOLIVIAN	BO
BOLIVIA OR PERU	ZZ
BOLIVIA PERU	ZZ
BOLIVIA PROBABLY	BO
BOLIVIAR	BO
BOLIVIE	BO
BOLIVIE ET PÉROU	ZZ
BOLIVIE L ÉTAT PLURINATIONAL DE	BO
BOLIVIE OU PÉROU	ZZ
BOMBAY	IN
BOMBAY INDIA	IN
BONAIRE	BQ
BONAIRE ISLAND W INDIES	BQ
BONAIRE NETHERLANDS ANTILLES	BQ
BONAIRE SAINT EUSTACHE ET SABA	BQ
BONAIRE SAINT EUSTATIUS	BQ
BONAIRE SAINT EUSTATIUS AND SABA	BQ
BONAIRE SINT EUSTATIUS AND SABA	BQ
BONAIRE THE NETHERLANDS ANTILLES	BQ
BONDY FRANCE	FR
BONGAO I	PH
BONGAO IS	PH
BONIN I	JP
BONIN IS	JP
BONIN ISLANDS	JP
BONIN ISLE	JP
BONNEVILLE DAM COLUMBIA RIVER WASHINGTON USA	US
BONVOULOIR	ZZ
BORÃS SWEDEN	SE
BORDEAUX FRANCE	FR
BORDEAUX GIRONDE FRANCE	FR
BORDER BOTSWANA AND SOUTH AFRICA	ZZ
BORDER SOUTH AFRICA AND BOTSWANA	ZZ
BORGLOON BELGIUM	BE
BORNEO	ZZ
BORNEÓ	ZZ
BORNÉO	ZZ
BORNEO BRUNEI	BN
BORNEO BRUNEI INDONESIA OR MALAYSIA	ZZ
BORNEO BRUNEI MALAYSIA INDONESIA	ZZ
BORNEO INDONESIA	ID
BORNEO INDONESIA MALAYASIA OR BRUNEI	ZZ
BORNEO IS	ZZ
BORNEO M	ZZ
BORNEOMALAYSIA	MY
BORNEO MALAYSIA	MY
BORNEO N	MY
BORNEO NORTH	MY
BORNEO OR SINGAPORE	ZZ
BORNÉO OU NORD DU SUMATRA DELI	ZZ
BORNEO SARAWAK MALAYSIA	MY
BORNHOLM BALTIC SEA	DK
BORSTEL GERMANY	DE
BOSNIA	BA
BOSNIÃ	BA
BOSNIA AND HERCEGOVINA	BA
BOSNIA AND HERZEGOVINA	BA
BOSNIA AND HERZEGOVINA CROATIA	BA
BOSNIA AND HERZEGOWINA	BA
BOSNIA CROATIA MACEDONIA SERBIA SLOVENIA	ZZ
BOSNIAHERCEGOVINA	BA
BOSNIA HERCEGOVINA	BA
BOSNIA HERCEGOVINA YUGOSLAVIA	BA
BOSNIA HERZEGOVINA	BA
BOSNIA HERZG	BA
BOSNIA Y HERZEGOVINA	BA
BOSNIE	BA
BOSNIE HERZÉGOVINE	BA
BOSPHORUS	TR
BOSTON MASSACHUSETTS USA	US
BOT	BW
BOTANICAL GARDEN KYOTO JAPAN	JP
BOTSUANA	BW
BOTSWANA	BW
BOTSWANA CAPTIVE	BW
BOTSWANA KALAHARI	BW
BOTSWANA KALAHARI CENTRAL	BW
BOTSWANA KGATHA	BW
BOTSWANA SOUTH AFRICA	ZZ
BOUGAINVILLE	SB
BOUGAINVILLE ISLANDS	SB
BOUNTY ISLAND	FJ
BOURBON OR REUNION I	ZZ
BOURGENBRESSE FRANCE	FR
BOUVET	BV
BOUVET I	BV
BOUVET ÎLE	BV
BOUVET IS	BV
BOUVET ISLAND	BV
B PAPUA	PG
B P INDIA	IN
BRA	BR
BRADFORT UK	GB
BRAINE LALLEUD BELGIUM	BE
BRANDENBURG	DE
BRASIL	BR
BRASILIA	BR
BRASILIEN	BR
BRAUNSCHWEIG GERMANY	DE
BRAZ	BR
BRAZIL	BR
BRAZIL ARGENTINA	ZZ
BRAZIL BOLIVIA	ZZ
BRAZIL CENTRAL	BR
BRAZIL CHILE	ZZ
BRAZIL COLOMBIA	ZZ
BRAZIL COLOMBIA OR VENEZUELA	ZZ
BRAZIL ECUADOR	ZZ
BRAZIL ERRONEOUS MEXICO	ZZ
BRAZIL GUIANA	ZZ
BRAZIL GUYANA	ZZ
BRAZIL GUYANA FRENCH GUIANA SURINAM	ZZ
BRAZILL	BR
BRAZIL NORTH	BR
BRAZIL OR ARGENTINA	ZZ
BRAZIL OR BOLIVIA	ZZ
BRAZIL OR COLOMBIA	ZZ
BRAZIL OR PERU	ZZ
BRAZIL OR SURINAM	ZZ
BRAZIL OR WEST INDIES	ZZ
BRAZIL PARAGUAY	ZZ
BRAZIL PERU	ZZ
BRAZIL PROBABLY	BR
BRAZIL PROBABLY BOLIVIA	ZZ
BRAZIL S E	BR
BRAZIL SOUTH AMERICA	BR
BRAZIL VENEZUELA	ZZ
BRAZZAVILLE	CG
BRB	BB
BR BURMA	MM
BR C AFRICA	MW
BR CAMEROONS	CM
BR CENTR AFRICA	MW
BR CENTR AFRICA NYASALAND	MW
BRCES PILI CAMARINES SUR PHILIPPINES	PH
BRD	DE
BR E AFRICA	KE
BR E AFRICA KENYA	KE
BR E AFRICA KENYA COLONY	KE
BR E AFRICA UGANDA	ZZ
BR EAST AFRICA	KE
BRESIL	BR
BRÉSIL	BR
BRÉSIL BRASIL BRAZIL BRASILIA	BR
BRESIL OU GUYANE	ZZ
BRÉSIL OU GUYANE	ZZ
BR GUIANA	GY
BR GUINEA	GY
BR HONDORAS	BZ
BR HONDURAS	BZ
BRIAZIL	BR
BRI CENTRAL AFRICA	MW
BR INDIA	IN
BR INDIA CEYLON	LK
BR INDIA N CEYLON	LK
BR IND OC TR	IO
BRISTISH GUIANA	GY
BRISTISH NEW GUINEA	GY
BRISTOL UK	GB
BRITAIN	GB
BRITAIN UK	GB
BRITAIN U K	GB
BRIT AM	ZZ
BRITANNIA (GB)	GB
BRIT ANTAR TER	AQ
BRIT C AFRICA	MW
BRIT CAMEROONS	CM
BRIT CENT AFRICA	MW
BRIT CENT AFRICA MALAWI	MW
BRIT CENT E AFRICA	MW
BRIT CENT PROTECTORATE AFRICA	MW
BRIT CENTR AFRICA	MW
BRIT CENTRAL AFRICA	MW
BRIT CENTR NEW GUINEA	PG
BRIT COLOMBIA	CA
BRIT COLUMBIA	CA
BRIT D NEW GUINEA	ID
BRIT E AF	KE
BRIT E AFRICA	KE
BRIT E AFRICA KENYA	KE
BRIT E AFRICA KENYA COLONY	KE
BRIT E AFRICA KENYA DISTRICT	KE
BRIT EAST AFRICA	KE
BRIT EAST AFRICA KENYA	KE
BRIT EAST AFRICA TANZANIA	TZ
BRIT EAST AFR KENYA	KE
BRIT GUIANA	GY
BRIT GUIANA LOCALITY DOUBTFUL	GY
BRIT HOND	BZ
BRIT HOND BÉLIZE	BZ
BRIT HONDURAS	BZ
BRIT HONDURAS BELIZE	BZ
BRIT INDIA	IN
BRIT INDIES	ZZ
BRITISH	GB
BRITISH AFRICA	ZZ
BRITISH AMERICA	ZZ
BRITISH AMERICA CANADA	CA
BRITISH ANTARCTIC TERRITORY	AQ
BRITISH BALUCHISTAN	ZZ
BRITISH BECHUANALAND	ZA
BRITISH BORNEO	PG
BRITISH CAMEROONS	CM
BRITISH CAMEROONS CAMEROON	CM
BRITISH CENTRAL AFRICA	MW
BRITISH CENTRAL AFRICA MALAWI	MW
BRITISH COAST	GB
BRITISH COLOMBIA	CA
BRITISH COLUMBIA	CA
BRITISH COLUMBIA CANADA	CA
BRITISH E AFRICA	KE
BRITISH EAST AFRICA	KE
BRITISH EAST AFRICA KENYA	KE
BRITISH EAST AFRICA KENYA AND TANZANIA	ZZ
BRITISH EAST AFRICA KENYA COLONY	KE
BRITISH EAST AFRICA KENYA OR TANZANIA	ZZ
BRITISH EAST AFRICA KENYA UGANDA TANZANIA	ZZ
BRITISH EAST AFRICA MALAWI	MW
BRITISH EAST AFRICA TANZANIA	TZ
BRITISH GUIANA	GY
BRITISH GUIANA GUYANA	GY
BRITISH GUIANA OR BRAZIL	ZZ
BRITISH GUIANA VENEZUELA	ZZ
BRITISH GUINA	GY
BRITISH GUYANA	GY
BRITISH HONDURAS	BZ
BRITISH HONDURAS BELIZE	BZ
BRITISH HONDURUS	BZ
BRITISH INDIA	IN
BRITISH INDIAN OCEAN TERRITORY	IO
BRITISH ISLES	ZZ
BRITISH MALAYA	ZZ
BRITISH N BORNEO	MY
BRITISH NEW GUINEA	PG
BRITISH NORTH BORNEO	MY
BRITISH NORTH BORNEO BORNEO	MY
BRITISH OVERSEAS TERRITORY	ZZ
BRITISH OVERSEAS TERRITORY: BERMUDA	BM
BRITISH PAPUA	PG
BRITISH SAMOA	WS
BRITISH SOLOMON ISLANDS	SB
BRITISH SOMALILAND	SO
BRITISH SOMILILAND	SO
BRITISH TERRITORY	ZZ
BRITISH U K	GB
BRITISH VIRGIN ID	VG
BRITISH VIRGIN IDS	VG
BRITISH VIRGIN IS	VG
BRITISH VIRGIN ISLANDS	VG
BRITISH VIRGIN ISLAND S	VG
BRITISH VIRGIN ISLANDS BRITISH	VG
BRITISH VIRGIN ISLS	VG
BRITISH VRIGIN IDS	VG
BRITISH WEST INDIES	ZZ
BRITISH WEST INDIES TURKS CAICOS ISLANDS	TC
BRIT ISLES	ZZ
BRIT N BORNEO	MY
BRIT NEW GUIANA	PG
BRIT NEW GUINEA	PG
BRIT N GUINEA	PG
BRIT RUANDA	RW
BRIT RUANDI	RW
BRIT S NEW GUINEA	PG
BRIT SOMALAILAND	SO
BRIT SOMALILAND	SO
BRIT SOUTH AFRICA	ZA
BRIT WEST INDIES	ZZ
BRIT W INDIES ANTIGUA I	AG
BRIT W INDIES ANTIGUA IS	AG
BRIT W INDIES BARBUDA I	AG
BRIT W INDIES BARBUDA IS	AG
BRIT W INDIES BEQUIA IS	VC
BRIT W INDIES DOMINICA I	DM
BRIT W INDIES DOMINICA IS	DM
BRIT W INDIES DOMINICA OR STA LUCIA	ZZ
BRIT W INDIES GRAND CAYMAN I	KY
BRIT W INDIES GRENADA I	GD
BRIT W INDIES GRENADA IS	GD
BRIT W INDIES GUADELOUPE I	GP
BRIT W INDIES JAMICA	JM
BRIT W INDIES STA LUCIA	LC
BRIT W INDIES STA LUCIA IS	LC
BRIT W INDIES ST LUCIA I	LC
BRIT W INDIES ST VINCENT I	VC
BRIT W INDIES ST VINCENT IS	VC
BRIT W INDIES TOBAGO	TT
BRIT W INDIES TOBAGO I	TT
BRIT W INDIES TOBAGO IS	TT
BRIT W INDIES TOBAGO ISLAND	TT
BRIT W INDIES TRINIDAD	TT
BR JAMAICA	JM
BRN	BN
BR NEW GUINEA	PG
BR NEW GUINEA N COAST	PG
BR N GUINEA	PG
BROOK I OR MIDWAY	CA
BR S AFRICA	ZA
BR SOLOMON IS	SB
BR SOMALILAND	SO
BR T GUIANA	GY
BRT GUIANA	GY
BRUGELETTE BELGIUM	BE
BRUGGE BELGIUM	BE
BRUNEI	BN
BRUNÉI	BN
BRUNEI DARSM	BN
BRUNEIDARUSSALAM	BN
BRUNEI DARUSSALAM	BN
BRUNEI EAST TIMOR INDONESIA MALAYSIA PHILIPPINES SINGAPORE THAILAND	ZZ
BRUNEI INDONESIA MALAYSIA	ZZ
BRUSSEL BELGIUM	BE
BRUSSELS	BE
BRUSSELS BELGIUM	BE
BRUXELLES	BE
BR VIRGIN IDS	VG
BR VIRGIN IS	VG
BR WEST INDIES TOBAGO	TT
BR W INDIES TOBAGO	TT
BR W INDIES TOBAGO I	TT
BTN	BT
BUCHARA	UZ
BUENO ARGENTINA	AR
BUFFALO NEW YORK USA	US
BUFFALO ZOO	US
BUGGENHOUT BELGIUM	BE
BUGUEY CAGAYAN PHILIPPINES	PH
BULG	BG
BULGARIA	BG
BULGARIA ROMANIA	ZZ
BULGARIE	BG
BUNDESREPUBLIK DEUTSCHLAND	DE
BUNGURAN I	ID
BUNGURAN IS	ID
BUR	ZZ
BURGARIJE	BG
BURKINA	BF
BURKINA BURKINA FASO	BF
BURKINAFASO	BF
BURKINA FASO	BF
BURKINA FASO COTE D IVOIRE	ZZ
BURKINA FASO PLATEAU CENTRAL	BF
BURKINAFASO PROVINCE DU PASSORÃ	BF
BURKINA FASO ZONE SAHEL AMP SOUDANOSAHEL	BF
BURKINO FASO	BF
BURMA	MM
BURMA BORDER	MM
BURMAH	MM
BURMAH BURMA MYANMAR	MM
BURMAH MYANMAR	MM
BURMA INDIA	ZZ
BURMA MALAYSIA SINGAPORE OR THAILAND	ZZ
BURMA MALAYSIA THAILAND	ZZ
BURMA MYANMAR	MM
BURMA NO LONGER EXISTS	MM
BURMA YUNNAN FRONTIER	ZZ
BURMINGHAM ENGLAND	GB
BURNT CREEK CANADIAN FAR NORTH	CA
BURTON LAKE ANTARTICA	AQ
BURU	ZZ
BURU I	ID
BURU IS	ID
BURUNDI	BI
BURUNDI CRÃªTES ZAÃRENIL	BI
BURUNDI ET TANZANIE	ZZ
BURUNDI KIRIMIRONORD	BI
BURUNDI OCCIDENTAL	BI
BURUNDI RWANDA	ZZ
BURUNDI TANZANIA ZAMBIA ZAIRE	ZZ
BUTÁN	BT
BVI	VG
BVT	BV
BWA	BW
BWAMANDA ZAIRE	CD
B WEST INDIES	ZZ
BWI	ZZ
B W I	ZZ
B W INDIES	ZZ
B W INDIES ST VINCENT	VC
BWI TOBAGO	TT
B W I TRINIDAD	TT
BWI TRINIDAD	TT
CAANADA	CA
CABINDA	AO
CABO VERDE	CV
CABRERA ISLAND	ES
CACHE VALLEY, LOGAN, UTAH, USA	US
CAESAREA	IL
CAF	CF
CAGLIARI ITALY	IT
CAICOS	TC
CAICOS IS	TC
CAICOS ISLANDS	TC
CAÏMANS ÎLES	KY
CAIRO EGYPT	EG
CAL	ZZ
CALCUTTA	IN
CALIFORNIA	US
CALIFORNIÃ	US
CALIFORNIA MEXICO	ZZ
CALIFORNIA USA	US
CALLENELLE BELGIUM	BE
CAM	CM
CAMAROON	CM
CAMAROONS	CM
CAMBERENE SENEGAL	SN
CAMBODGE	KH
CAMBODIA	KH
CAMBODIA LAOS VIETNAM	ZZ
CAMBODIA THAILAND VIETNAM	ZZ
CAMBODIA VIETNAM	ZZ
CAMBODJA	KH
CAMBOGE	KH
CAMBOYA	KH
CAMBRIDGE UK	GB
C AMERICA	ZZ
C AMERICA OR MEXICO	ZZ
CAMERON	CM
CAMEROON	CM
CAMEROON CENT AFRICAN REP	ZZ
CAMEROON CENTAL AFRICAN REPUBLIC	ZZ
CAMEROON CENTRAL AFRICAN REP	ZZ
CAMEROON HIGHLANDS	CM
CAMEROON N	CM
CAMEROON NIGERIA	ZZ
CAMEROON NORTH	CM
CAMEROON OR C A R	ZZ
CAMEROON OR LIBERIA	ZZ
CAMEROON PROBABLY	CM
CAMEROONS	CM
CAMEROON S	CM
CAMEROONS BRITISH CAMEROON	CM
CAMEROONS CAMEROON	CM
CAMEROONS CAMEROON W AFRICA	CM
CAMEROONS CAMEROON WEST AFRICA	CM
CAMEROONS S	CM
CAMEROONS SOUTH	CM
CAMEROONS WEST AFRICA	CM
CAMEROON WEST	CM
CAMEROUN	CM
CAMEROUN CAMEROON	CM
CAMEROUN NORDEST	CM
CAMEROUN PROVINCE DU NORDOUEST PEUPLE FULANI	CM
CAMERUN	CM
CAMERÚN	CM
CAMIGUIN	PH
CAMPBELL IS	ZZ
CAMPBELL ISLAND	ZZ
CAMPINAS BRAZIL	BR
CAMR	CM
CAN	CA
CANAD	CA
CANADA	CA
CAN ADA	CA
CANADÁ	CA
CANADÀ	CA
CANADA ALBERTA COLD CREE	CA
CANADA ALBERTA PROSPECT CREE	CA
CANADA AND GREENLAND	ZZ
CANADA CAVEN LAK	CA
CANADA GREENLAND	ZZ
CANADA MEXICO W INDIES	ZZ
CANADA MEX WEST INDIES	ZZ
CANADA NEW BRUNSWICK CHARLOTTE CO ST ANDREWS	CA
CANADA; NUNAVUT	CA
CANADA; NWT	CA
CANADA ONTARIO	CA
CANADA OR ALASKA	ZZ
CANADA OR UNITED STATES	ZZ
CANADA OR USA	ZZ
CANADA PROBABLE	CA
CANADA UNITED STATES	ZZ
CANADA USA	ZZ
CANADIAN FAR NORTH	CA
CANAL DE SUEZ	EG
CANAL DU MOZAMBIQUE	ZZ
CANAL ZONE	PA
CANAL ZONE PANAMA	PA
CANANDA	CA
CANARIES	ES
CANARIES I	ES
CANARY I	ES
CANARY IDS	ES
CANARY IS	ES
CANARY ISL	ES
CANARY ISLAND	ES
CANARY ISLANDS	ES
CANARY ISLAND S	ES
CANARY ISLANDS SPAIN	ES
CANAS PUERTO RICO	PR
CAN BR COLUM	CA
CANDA	CA
C AND E SOUTH AMERICA	ZZ
C ANGOLA	AO
CAN MARITIMS	CA
CAN NEWFOUNL	CA
CANOE BEACH TEMA GHANA	GH
CAN QUEBEC	CA
CAP	ZZ
CAPE COLONY	ZA
CAPE PROVINCE	ZA
CAP ERIO	ZZ
CAPE SEAS I E SOUTH AFRICAN SEAS	ZZ
CAPEVERDE	CV
CAPE VERDE	CV
CAPE VERDE CHILE	ZZ
CAPE VERDE IDS	CV
CAPE VERDE IS	CV
CAPE VERDE ISLAND	CV
CAPE VERDE ISLANDS	CV
CAPE VERDE ISLAND S	CV
CAPE VERDE ISLANE	CV
CAPOY SORSOGON SORSOGON PHILIPPINES	PH
CAPT	ZZ
CAPTIVE	ZZ
CAPTIVE ANIMAL	ZZ
CAPTIVE BIRD	ZZ
CAPTIVE BORN	ZZ
CAPTIVE CINCINNATI ZOO	ZZ
CAPTIVE IN UNITED KINGDOM	GB
CAPTIVE IN USA	US
CAPTIVE REARED IN USA	US
CAPTIVITY	ZZ
CAP VERD	CV
CAP VERDE ISLANDS	CV
CAP VERT	CV
CAP VERT I	CV
CAR	ZZ
CARANISCHE EILANDEN	ES
CARDIFF WALES	GB
CARGADOS CARAJOS	MU
CARIBBEAN	ZZ
CARIBBEAN AREA	ZZ
CARIBBEAN SEA	ZZ
CARIBBEAN SEA ISLAND S	ZZ
CARIMAGUA COLOMBIA	CO
CARINTHIA	AT
CAR NICOBAR	IN
CAR NICOBAR IS	IN
CAROLINE I	ZZ
CAROLINE IS	ZZ
CAROLINE ISLAND	ZZ
CAROLINE ISLANDS	ZZ
CAROLINE ISLS	ZZ
CAROLINES	ZZ
CAROLINES I	ZZ
CARRIACOU ST VINCENT AND THE GRENADINES	ZZ
CARRIBEAN	ZZ
CARRIBEAN AREA	ZZ
CARRIBEAN SEA	ZZ
CASHMERE	ZZ
CASIGAN NARRA PALAWAN PHILIPPINES	PH
CASPIA	ZZ
CASPIAN SEA	ZZ
CÃTE DIVOIRE	CI
CÃTE SAINT ANDRÃ FRANCE	FR
CAUCACUS	ZZ
CAUCASIA	ZZ
CAUCASIE	ZZ
CAUCASUS	ZZ
CAUCASUS RUSSIA	RU
CAUCUSUS	ZZ
CAUGHT OFF THE NORTH CAPE OF NORWAY	NO
C AUSTRALIA	AU
CÃVENNES FRANCE	FR
CAYMAN	KY
CAYMAN I	KY
CAYMAN IDS	KY
CAYMAN IS	KY
CAYMAN ISLAND	KY
CAYMAN ISLANDS	KY
CAYMAN ISLAND S	KY
CAYMAN ISLANDS WEST INDIES	KY
CAYMANS	KY
CAYMEN IDS	KY
CAYOAGAN ISLAND	PH
C BOLIVIA	BO
C BRIT NEW GUINEA	PG
C CELEBES	ID
C CHILE	CL
C CHINA	CN
CCK	CC
C D MADAGASCAR	MG
C D NEW GUINEA	ID
C ECUADOR	EC
CELEBES	ID
CELEBES I	ID
CELEBES IS	ID
CELEBES ISLAND	ID
CELEBES SEA	ZZ
CELEBES SULAWESI	ID
CELEBRES	ID
C E MADAGASCAR	MG
CENBA ILLEG	ZZ
CEN BOLIVIA	BO
CEN MEXICO	MX
CENT AFR REP	CF
CENT AUSTRALIA	AU
CENT BOLIVIA	BO
CENT BRITISH AFRICA	MW
CENT CELEBES	ID
CENT CHINA	CN
CENT CONGO	ZZ
CENT D NEW GUINEA	ID
CENT D N GUINEA	ID
CENT DU NEW GUINEA	ID
CENT DUTCH NEW GUINEA	ID
CENT DUTCH N GUINEA	ID
CENT DUT NEW GUINEA	ID
CENTER AUSTRALIA	AU
CENTER BOLIVIA	BO
CENTER E MADAGASCAR	MG
CENTER MADAGASCAR	MG
CENTER OF MADAGASCAR	MG
CENTER S MADAGASCAR	MG
CENTER S W MADAGASCAR	MG
CENT FORMOSA	TW
CENT FORMOSA IS	TW
CENT GERMANY	DE
CENT GUAT	GT
CENT HIGHLANDS N GUINEA	PG
CENT INDIA	IN
CENT JAPAN	JP
CENT LOO CHOO IS	JP
CENT LOOCHOO IS	JP
CENT MADAGASCAR	MG
CENT MAROCCO	MA
CENT MOROCCO	MA
CENT NEW GUINEA	PG
CENT PERSIA	ZZ
CENT PYRENEES	ZZ
CENTRA AMERICA	ZZ
CENTRAFRICAINE RÉPUBLIQUE	CF
CENTRAFRICAN REPUBLIC	CF
CENTRAFRICA REPUBLIC	CF
CENTRAFRIQUE	CF
CENTRAL AFGHANISTAN	AF
CENTRAL AFRICA	ZZ
CENTRAL AFRICAN EMPIRE	CF
CENTRAL AFRICAN REP	CF
CENTRAL AFRICAN REPUBLIC	CF
CENTRAL AFRICA REPUBLIC	CF
CENTRAL AFR. RP	CF
CENTRAL AMERICA	ZZ
CENTRAL AMERICA NORTHERN SOUTH AMERICA	ZZ
CENTRAL AND SOUTH AMERICA	ZZ
CENTRAL AND SOUTHERN AMERICA	ZZ
CENTRAL ASIA	ZZ
CENTRAL AUSTRALIA	AU
CENTRAL BOHEMIA	CZ
CENTRAL BOLIVIA	BO
CENTRAL BRAZIL	BR
CENTRAL CEYLON	LK
CENTRAL CHILE	CL
CENTRAL CHINA	CN
CENTRAL CROPS RESEARCH STATION CLAYTON NORTH CAROLINA USA	US
CENTRAL DIVISION PAPUA	PG
CENTRAL DIV PAPUA	PG
CENTRAL DUTCH GUINEA	ID
CENTRAL DUTCH NEW GUINEA	ID
CENTRAL DUTCH N GUINEA	ID
CENTRAL E MADAGASCAR	MG
CENTRAL EUROPE	ZZ
CENTRAL EUROPE PROBABLY	ZZ
CENTRAL EXPERIMENTAL FARM OTTAWA ONTARIO CANADA	CA
CENTRAL FORMOSA	TW
CENTRAL GUATEMALA	GT
CENTRAL INDIA	IN
CENTRAL ITALY	IT
CENTRAL JAPAN	JP
CENTRAL JAVA INDONESIA	ID
CENTRAL KALAHARI	ZZ
CENTRAL LITHUANIA	LT
CENTRAL LOO CHOO IS	JP
CENTRAL MADACASCAR	MG
CENTRAL MADAGASCAR	MG
CENTRAL MALAWI	MW
CENTRAL MOROCCO	MA
CENTRAL N LOO CHOO IS	JP
CENTRAL PERU	PE
CENTRAL POLYNESIA	ZZ
CENTRAL PYRENEES	ZZ
CENTRAL REGION	ZZ
CENTRAL SAHARA	ZZ
CENTRAL S E MADAGASCAR	MG
CENTRAL SLOVAKIA	SK
CENTRAL SOUTH AMERICA	ZZ
CENTRAL SULAWESI	ID
CENTRAL TAIWAN	TW
CENTRAL THAILAND	TH
CENTR AUSTRALIA	AU
CENTR BOLIVIA	BO
CENTR BR NEW GUINEA	PG
CENTR BR S AFRICA	ZA
CENTR BURU	ID
CENTR BURU I	ID
CENTR CELEBES	ID
CENTR CEYLON	LK
CENTR CHINA	CN
CENTR DU NEW GUINEA	ID
CENTR DUTCH NEW GUINEA	ID
CENTREAFRICANA REPÚBLICA	CF
CENTRE AFRIQUE RÃGION DE LA LOBAYE OUBANGICHARI	CF
CENTRE E COAST MADAGASCAR	MG
CENTRE MADAGASCAR	MG
CENTR INDIA	IN
CENTR ITALY	IT
CENTR JAVA	ID
CENTR MADAGASCAR	MG
CENTR MOLUCCAS	ID
CENTR MOLUCCA S	ID
CENTR MOROCCO	MA
CENTR NEW CALEDONIA	NC
CENTR NORWAY	NO
CENTRO COAST E MADAGASCAR	MG
CENTR PERSIA	ZZ
CENTR RUSSIA	RU
CENTR SIAM	TH
CENTR SPAIN	ES
CENTR TUNIS	TN
CENTR WEST AUSTRALIA	AU
CENT SAHARA	ZZ
CENT S LOO CHOO IS	JP
CENT SPAIN	ES
CERAM	ID
CERAM IS	ID
CERAM ISLAND	ID
CERAM LAUT	ID
CERAM LAUT IS	ID
CERIGO I	GR
CERNIKA	SI
CERRO GORDO IOWA UNITED STATES	US
ČESKÁ REPUBLIKA	CZ
CEYL	LK
CEYLAN	LK
CEYLON	LK
CEYLON I	LK
CEYLON INDIA	ZZ
CEYLON IS	LK
CEYLON OR INDIA	ZZ
CEYLON OR MALAYA	ZZ
CEYLON SOUTH	LK
CEYLONSRILANKA	LK
CEYLON SRILANKA	LK
CEYLON SRI LANKA	LK
C FORMOSA	TW
CF ZAIRE	CD
C GER NEW GUINEA	PG
CHACO OF PARAGUAY	PY
CHAD	TD
CHAD OR SOMALIA	ZZ
CHAGAS ARCHIPELAGO	IO
CHAGOS ARCH	IO
CHAGOS ARCHIPELAGO	IO
CHAGOS ARCHIPELAGO BRITISH INDIAN OCEAN TERRITORY	IO
CHAGOS IS	IO
CHALK REGION KENT UK	GB
CHANNEL IS	ZZ
CHANNEL ISL	ZZ
CHANNEL ISLANDS	ZZ
CHANNEL ISLANDS UK	ZZ
CHARENTES MARITIMES FRANCE	FR
CHARLEROI BELGIUM	BE
CHARLEVILLE FRANCE	FR
CHATHAM	NZ
CHATHAM I	NZ
CHATHAM I E OF NEW ZEALAND	NZ
CHATHAM I OR N Z	NZ
CHATHAM IS	NZ
CHATHAM ISLAND	NZ
CHATHAM ISLANDS	NZ
CHATHAM ISLANDS NEW ZEALAND	NZ
CHAUSEY I	FR
CHE	CH
CHECHOSLOVAKIA	ZZ
CHECH REPUBLIC	CZ
CHECK	ZZ
CHENAL DES SABLETTES	FR
CHESAPEAKE BAY MARYLAND USA	US
CHESTERFIELD BANK	NC
CHESTERFIELD I	NC
CHESTERFIELD ISLAND	NC
CHETNEY MARSHES KENT UK	GB
CHI	ZZ
CHICAGO USA	US
CHIEMSEE BAVARIA GERMANY	DE
CHIL	CL
CHILE	CL
CHILE ARGENTINA	ZZ
CHILE CHILI	CL
CHILE OR ARGENTINA	ZZ
CHILE PERU	ZZ
CHILES	CL
CHILI	CL
CHILI CHILE	CL
CHILI CHILE OR CENTRAL AMERICA	ZZ
CHILI OU PEROU	ZZ
CHIMAY	BE
CHIN	CN
CHINA	CN
CHINA BY INFERENCE	CN
CHINA E TIBET	CN
CHINA FRENCH INDOCHINA	CN
CHINA FRENCH INDO CHINA	CN
CHINA INDIA	ZZ
CHINA INDIA PAKISTAN	ZZ
CHINA KAZAKHSTAN MONGOLIA RUSSIA	ZZ
CHINA KITAY	CN
CHINA MAIN	CN
CHINA MONGOLIA	ZZ
CHINA MONGOLIA RUSSIA	ZZ
CHINA N TIBET	CN
CHINA OR JAPAN	ZZ
CHINA OR MALAY	ZZ
CHINA PEOPLE S REPUBLIC	CN
CHINA PR	CN
CHINA SEA	ZZ
CHINA SEAS	ZZ
CHINA TIBET	CN
CHINA W MONGOLIA	ZZ
CHINCHAS ISLANDS	PE
CHINE	CN
CHINE CHINA	CN
CHINEESTURKESTAN	ZZ
CHINE OU JAPON	ZZ
CHINE RUSSIE	ZZ
CHINESE TAIPEI	TW
CHINESE TURKESTAN	ZZ
CHIPRE	CY
CHIRIQUE	ZZ
CHL	CL
CHLLE	CL
CHN	CN
CHOSEN	ZZ
CHRISTMAS	ZZ
CHRISTMAS I	ZZ
CHRISTMAS ID	ZZ
CHRISTMAS ÎLE	ZZ
CHRISTMAS IS	ZZ
CHRISTMAS ISLAND	ZZ
CHRISTMAS ISLAND INDIAN OCEAN	CX
CHUBAT	AR
CHUKCHI SEA	ZZ
CHYPRE	CY
CHYPRE I	CY
CINCINNATI USA	US
C ITALY	IT
CITY AIRPORT GUATEMALA	GT
CIUDAD DEL VATICANO	VA
CIV	CI
CLARKE RESERVATION NEW YORK USA	US
CLERMONTFERRAND	FR
CLEVELAND USA	US
CLINKER GULCH SOUTH SANDWICH ISLANDS	GS
CLIPPERTON	FR
CLIPPERTON I	FR
CLIPPERTON ID	FR
CLIPPERTON IS	FR
CLIPPERTON ISLAND	FR
C LOO CHOO IS	JP
C MADAGASCAR	MG
C MAROCCO	MA
C MOROCCO	MA
C MORROCCO	MA
CMR	CM
C NIGERIA	NG
CNMI	ZZ
C NORWAY	NO
COAS OF LIBERIA	LR
COAST E MADAGASCAR	MG
COAST FR SOMALILAND	DJ
COAST N E MADAGASCAR	MG
COAST NEW CALEDONIA	NC
COAST N ICELAND	IS
COAST OF AUSTRALIA	AU
COAST OF BELGIUM CONGO	CD
COAST OF CHILE	CL
COAST OF CONGO	ZZ
COAST OF GER E AFRICA	ZZ
COAST OF KENYA COLONY	KE
COAST OF N ICELAND	IS
COAST OF NORTH ICELAND	IS
COAST OF PERU	PE
COAST OF S E AUSTRALIA	AU
COAST OF VENEZUELA	VE
COAST OF W COLOMBIA	CO
COAST OF W ECUADOR	EC
COAST OF W SUMATRA	ID
COAST S E MADAGASCAR	MG
COAST S W MADAGASCAR	MG
COAST W SUMATRA	ID
COCHIN CHINA	VN
COCOS	ZZ
COCOS I	ZZ
COCOS I CR	CR
COCOS IDS	CC
COCOS IS	ZZ
COCOS ISALAND	CR
COCOS ISL	ZZ
COCOS ISLAND	CR
COCOS ISLAND COSTA RICA	CR
COCOS ISLAND OFF PANAMA	CR
COCOS ISLANDS	CC
COCOS KEELING GROUP	CC
COCOS KEELING ÎLES	CC
COCOS KEELING IS	CC
COCOS KEELING I S	CC
COCOS KEELING ISL	CC
COCOS KEELING ISLANDS	CC
COD	CD
COG	CG
COK	CK
COL	CO
COLCHESTER ENGLAND	GB
COLL	CO
COLLECTIVITÉ FRANÇAISE	ZZ
COLMAR FRANCE	FR
COLMBIA	CO
COLO	CO
COLOM	CO
COLOMBIA	CO
COLÒMBIA	CO
COLOMBIA BRAZIL	ZZ
COLOMBIA ECUADOR	ZZ
COLOMBIA OR BRAZIL	ZZ
COLOMBIA OR ECUADOR	ZZ
COLOMBIA OR PANAMA	ZZ
COLOMBIA PANAMA	ZZ
COLOMBIA PROBABLY	CO
COLOMBIA SOUTH AMERICA	CO
COLOMBIA TER	CO
COLOMBIA VENEZUELA	ZZ
COLOMBIE	CO
COLOMBIE COLOMBIA	CO
COLOMBIE VENEZUELA	ZZ
COLOMIA	CO
COLOM OR ECUA	ZZ
COLONY OF HONG KONG	HK
COLORADO	US
COLORADO SPRINGS COLORADO USA	US
COLORADO USA	US
COLUMBA	CO
COLUMBIA	CO
COLUMBIA COLOMBIA	CO
COLUMBIA ECUADOR	ZZ
COLUMBIEN	CO
COM	KM
C O MADAGASCAR	MG
ÇOMALIS	ZZ
COMMANDER I	RU
COMMANDER IS	RU
COMMANDER ISLAND	RU
COMMANDER ISLANDS	RU
COMMANDER ISLDS	RU
COMMANDER ISLES	RU
COMMONWEALTH NORTHERN MARIANA ISLANDS	MP
COMMONWEALTH OF AUSTRALIA	AU
COMMONWEALTH OF PUERTO RICO	PR
COMMONWEALTH OF THE BAHAMAS	BS
COMMONWEALTH OF THE NORTHERN MARIANA IS	MP
COMMONWEALTH OF THE NORTHERN MARIANA ISLANDS	MP
COMORAS	KM
COMORE IS	KM
COMORE ISLANDS	KM
COMOREN	KM
COMOREN ISL	KM
COMORES	KM
COMORES ARCH	KM
COMORES ISLANDS	KM
COMORO I	KM
COMORO I E OF AFRICA	KM
COMORO IS	KM
COMORO IS ANGOLA	KM
COMORO ISLANDS	KM
COMORO IS MAYOTTE	ZZ
COMORO IS OFF E AFRICA	KM
COMORO IS UNION COMOROS	KM
COMOROS	KM
COMOROS IS	KM
COMOROS ISLANDS	KM
COMORROS OR GLORIOSA	ZZ
CON	ZZ
CONG	CG
CONGO	ZZ
CONGO AFRICA	ZZ
CONGO BELGE	CD
CONGO BELGE RÃP DÃMOCRATIQUE DU CONGO	CD
CONGO BELGIAN	CD
CONGO BORDER	ZZ
CONGO BRAZAVILLE	CG
CONGO BRAZZAVILLE	CG
CONGO BURUNDI	ZZ
CONGO CONGO DEM REP OF THE	CD
CONGO DEMOCRATIC REP OF	CD
CONGO DEMOCRATIC REPUBLIC	CD
CONGO DEMOCRATIC REPUBLIC OF	CD
CONGO DEMOCRATIC REPUBLIC OF THE	CD
CONGO DEM REP	CD
CONGO DEM REP OF THE	CD
CONGO DEM RP	CD
CONGO DR	CD
CONGO, DRC	DC
CONGO FRANÇAIS	ZZ
CONGO FRANÇAIS OU GABON	ZZ
CONGO FREE ST	CD
CONGO FREE STATE	CD
CONGO FRENCH VIC	ZZ
CONGO FR ST	CD
CONGO F S	CD
CONGO F ST	CD
CONGO F STATE	CD
CONGO GABON	ZZ
CONGO GABOON	ZZ
CONGO K	CD
CONGOKINSHASA	CD
CONGO KINSHASA	CD
CONGO LA RÉPUBLIQUE DÉMOCRATIQUE DU	CD
CONGOLEOPOLDVILLE	CG
CONGO LEOPOLDVILLE	CG
CONGO OR ZAMBIA	ZZ
CONGO OU GABON	ZZ
CONGO PROBABLE	ZZ
CONGO RÃP POPULAIRE DU CONGO	CG
CONGO REP	CG
CONGO REPUBLIC	CG
CONGO REPUBLIC OF THE	CG
CONGO RUPUBLIC	CG
CONGO RWANDA	ZZ
CONGO RWANDA ZAIRE	ZZ
CONGO RWANDA ZIMBABWE	ZZ
CONGO THE DEMOCRATIC REPUBLIC OF THE	CD
CONGO TO KENYA	ZZ
CONGO ZAIRE	CD
CONN	US
CONNECTICUT USA	US
CONTESTÉ GUYANE BRÉSIL	ZZ
CONTINENTAL INDIA	IN
CONTREXEVILLE PAVILLON SPRING FRANCE	FR
COO	CK
COOK ARCHIPELAGO	CK
COOK I	CK
COOK ÎLES	CK
COOK IS	CK
COOK ISL	CK
COOK ISLAND	CK
COOKISLANDS	CK
COOK ISLANDS	CK
COOKS	CK
CO OPERATIVE REPUBLIC OF GUYANA	GY
COOS COUNTRY OREGON USA	US
COPENHAGEN DENMARK	DK
COR	ZZ
CORAL SEA	ZZ
CORAL SEA AUSTRALIA	AU
COREA	KR
COREA DEL NORTE	KP
COREA DEL SUR	KR
COREE	KR
CORÉE	KR
CORÉE DU NORD	KP
COREE DU SUD	KR
CORÉE DU SUD	KR
CORÉE RÉPUBLIQUE DE	KR
CORÉE RÉPUBLIQUE POPULAIRE DÉMOCRATIQUE DE	KP
CORFU IS	GR
CORINTH GREECE	GR
CORSE	FR
CORSICA	FR
CORSICA FRANCE	FR
CORSICA I	FR
CORTEZ BANK	US
CORTEZ BANKS	US
COS	CR
COSICA	FR
COSMOLEDO IS	SC
COSMOLEDO ISLANDS	SC
COST	CR
COSTA DE MARFIL	CI
COSTA D IVORI	CI
COSTA R	CR
COSTARICA	CR
COSTA RICA	CR
COSTA RICA NICARAGUA	ZZ
COSTA RICA PANAMA	ZZ
COSTA RICO	CR
COSTA ROCA	CR
COSTI RICA	CR
COTE D	CI
COTEDIVOIRE	CI
COTE DIVOIRE	CI
COTE D IVOIRE	CI
CÔTE D IVOIRE	CI
CÔTE D IVOIRE ET GUINÉE	ZZ
COTE DIVOIRE IVORY COAST	CI
COTE D IVOIRE LIBERIA	ZZ
CÔTE D IVOIRE PROBABLE	CI
CÔTE D OR	CI
COU	ZZ
COUNTRY	ZZ
COUNTRY OF ORIGIN UNKNOWN	ZZ
COURTOWN KEY	ZZ
C P	ZZ
C PERU	PE
C P S A	ZA
CPV	CV
C R	ZZ
CRANDON PARK ZOO	US
CRC	ZZ
CREDNER I	PG
CRETE	GR
CRETE GREECE	GR
CRETE I	GR
CRETE IS	GR
CREZCHO SLOVAKIA	ZZ
CRI	CR
CRIMEA	UA
CROACIA	HR
CROATIA	HR
CROATIA HRVATSKA	HR
CROATIE	HR
CROIX SCAILLE BELGIUM	BE
CROIXSCAILLE BELGIUM	BE
CROYDON UK	GB
CROZET I	TF
CROZET IS	TF
CROZET ISLAND	TF
CROZET ISLANDS	TF
C RUSSIA	RU
CRYSTAL LAKE ILLINOIS USA	US
C S AMER	ZZ
C S AMERICA	ZZ
C S AUSTRALIA	AU
CSFR	ZZ
C SIAM	TH
C SIBERIA	RU
CSR	CZ
CT	US
CUB	CU
CUBA	CU
CUBA IN ERROR	ZZ
CUBA OR HAITI	ZZ
CUBA TRINIDAD AND TOBAGO	ZZ
CUBA W INDIES	CU
CULAPE LUCBAN QUEZON PHILIPPINES	PH
CURAÃAO	CW
CURAÃAO I	CW
CURACAO	CW
CURAĈAO	CW
CURAÇAO	CW
CURACAO I	CW
CURACAO ISLAND	CW
CURACOS	CW
CURAÏAO	CW
CURAÏAO I	CW
CURAO	CW
CUW	CW
CUYAHOGA OHIO UNITED STATES	US
CXR	CX
CYM	KY
CYP	CY
CYPRESS	CY
CYPRESS IS	CY
CYPRUS	CY
CYPRUS I	CY
CYPRUS IS	CY
CYPRUS KÝPROS	CY
CYPRUSS	CY
CYPRUS SWITZERLAND	ZZ
CYRENAICA	LY
CZE	CZ
CZECHIA	CZ
CZECHIA (THE CZECH REPUBLIC)	CZ
CZECH LANDS	CZ
CZECHOSLAVAKIA	ZZ
CZECHOSLAVAKIA GERMANY POLAND	ZZ
CZECHOSLAVIA	ZZ
CZECHO SLOV	ZZ
CZECHOSLOVAKIA	ZZ
CZECHO SLOVAKIA	ZZ
CZECHOZLOVAKIA	ZZ
CZECH REP	CZ
CZECH REPUBLIC	CZ
CZECH REPUBLIC CZECHOSLOVAKIA	CZ
CZECH REPUBLIC GERMANY POLAND	ZZ
CZECH REPUBLIC POLAND	ZZ
CZECH REPUBLIC SLOVAKIA	ZZ
CZECH RUPUBLIC	CZ
CZECKOSLOVAKI	ZZ
DAGESTAN	RU
DAGHESTAN	RU
DAHOMEY	BJ
DAKAR BEL AIR SENEGAL	SN
DALLAS USA	US
DALMATIA	HR
DALMATIA CROATIA	HR
DALMATIEN	HR
DAMARALAND	NA
DAMMER I	ID
DAMMER IS	ID
DANDERYD SWEDEN	SE
DANEMARK	DK
DANGER GROUP	AQ
DANGER ISLANDS	AQ
DANISH WEST INDIES	VI
DANMARK	DK
DANZIG	PL
DANZIG F S	PL
DAQING VALLEY TONGLIAO MONGOLIA CHINA	MN
DARESSALAAM	TZ
DARTMOOR UK	GB
DAVIS	US
DAVIS CALIFORNIA USA	US
DAVIS STRAIT	ZZ
DAVIS STRAITS	ZZ
DAWSON I	ZZ
DDR	DE
DEAD SEA	ZZ
DEAD SEA ISRAEL	IL
D EAST INDIES	ZZ
DEATH VALLEY CALIFORNIA USA	US
DE BLANKAART BELGIUM	BE
DEE RIVER CHESHIRE UK	GB
DEHLI INDIA	IN
D E IND	ID
D E INDIES	ID
D E INDIES N E SUMATRA	ID
D E INDIES ST SUMATRA	ID
DELAWARE	US
DELFT THE NETHERLANDS	NL
DELTA AREA EGYPT	EG
DEMARARA	GY
DEMOCRATIC DEMOCRATIC REPUBLIC OF THE CONGO	CD
DEMOCRATIC PEOPLES REPUBLIC OF KOREA	KP
DEMOCRATIC REPUBLIC CONGO	CD
DEMOCRATIC REPUBLIC OF CONGO	CD
DEMOCRATIC REPUBLIC OF CONGO RWANDA	ZZ
DEMOCRATIC REPUBLIC OF CONGO TANZANIA	ZZ
DEMOCRATIC REPUBLIC OF CONGO ZAIRE	CD
DEMOCRATIC REPUBLIC OF THE CONGO	CD
DEMOCRATIC REPUBLIC OF THE CONGO CONGO BELGE	CD
DEMOCRATIC REPUBLIC OF THE CONGO REPUBLIC OF CONGO RWANDA	ZZ
DEMOCRATIC REPUBLIC OF THE CONGO RWANDA	ZZ
DEMOCRATIC REPUBLIC OF THE CONGO TANZANIA	ZZ
DEMOCRATIC REPUBLIC OF THE CONGO UGANDA	ZZ
DEMOCRATIC REPUBLIC OF TIMOR LESTE	TL
DEMOCRATIC SOCIALIST REPUBLIC OF SRI LANKA	LK
DEMOCRATIC YEMEN	YE
DEM REP CONGO	CD
DEM REP OF CONGO	CD
DEM REP OF THE CONGO	CD
DEN	DK
DENEMARKEN	DK
DEN HAAG THE NETHERLANDS	NL
DENM	DK
DENMAK	DK
DENMARK	DK
DENMARK CANADA	ZZ
DENMARK EB	DK
DENMARK FAEROE ISLANDS	FO
DENMARK GREENLAND	GL
D ENTRECASTEAUX	PG
DÉPARTEMENT FRANÇAIS	ZZ
DEPT BACT COUNTY HOSPITAL GYULA HUNGARY	HU
DESERT ALGERIA	DZ
DESIRADE	GP
DESIRADE ISLAND	GP
DETROIT DE MALACCA	ZZ
DEU	DE
DEUTSCHLAND	DE
DEUTSCH OST AFRIKA	ZZ
DEUX SÃVRES FRANCE	FR
D GUIANA	SR
D GUIANA INTERIOR OF SURINAM	SR
D GUIANA SUR	SR
D GUIANA SURINAM	SR
D GUINEA	GH
DIABALI NIONO MALI	ML
DIEULOUARD FRANCE	FR
DIEU LOUARD MEURTHE ET MOSELLE FRANCE	FR
DINAMARCA	DK
DIST N CENTRAL GUINEA	PG
DISTRICT OF COLUMBIA WASHINGTON D C	US
DIWANIYAH QADISYA AREA IRAQ	IQ
DJAMPEA I	ID
DJAMPEA I S OF CELEBES	ID
DJI	DJ
DJIBOUTI	DJ
DJIBOUTI SOMALIA	ZZ
DMA	DM
D NEW GUINA	ID
D NEW GUINEA	ID
D N GUINEA	ID
DNK	DK
DOEL BELGIUM	BE
DOM	DO
DOMI	DM
DOMICAN REPUBLIC	DO
DOMINIAN REPUBLIC	DO
DOMINICA	DM
DOMINICAINE RÉPUBLIQUE	DO
DOMINICA ISLAND	DM
DOMINICA I W I	DM
DOMINICA LESSER ANTILLES	DM
DOMINICANA REPÚBLICA	DO
DOMINICANR	DO
DOMINICAN REP	DO
DOMINICAN REPEBLIC	DO
DOMINICAN REPUB	DO
DOMINICANREPUBLIC	DO
DOMINICAN REPUBLIC	DO
DOMINICAN REPUBLIC HAITI	ZZ
DOMINICAN REPUBLIC OR HAITI	ZZ
DOMINICAN REUBLIC	DO
DOMINICAN RP	DO
DOMINIQUE	DM
DOMMICAN REPUBLIC	DO
DOMR	DO
DOM REPUBLIC	DO
DOR	ZZ
DORO WAKAYAMA PREF JAPAN	JP
DOUALA CAMEROON	CM
DOWNE UK	GB
DRC	CD
D R CONGO	CD
DR CONGO	CD
DREISAM RIVER FREIBURG GERMANY	DE
DRESUND DENMARK	DK
DROC	CD
DROGENBOS BELGIUM	BE
DRONNING MAUD LAND	AQ
DUBAI	AE
DUBLIN IRELAND	IE
DUCIE ISLAND	PN
DU GUIANA	SR
DUISTLAND	DE
DUITLAND	DE
DUKE OF YORK GP	PG
DUKE OF YORK I	PG
DUKE OF YORK I BISMARCK ARCHIP	PG
DUKE OF YORK I OR NEW BRITAIN	PG
DUKE OF YORK I OR NEW IRELAND	PG
DUKE OF YORK IS	PG
DUKE OF YORK ISLAND	PG
DU NEW GUIANA	ID
DU NEW GUINEA	ID
DU NEW GUINEA EAST COAST	ID
DUPLICATE CAST VP DUPLICATE CAST VPPU	ZZ
DUPLICATE CAST VP DUPLICATE CAST VP VP	ZZ
DURHAM USA	US
DUTCH ANTILLES	ZZ
DUTCH AUSTRIA	ZZ
DUTCH BORNEO	ID
DUTCH BORNEO BORNEO	ID
DUTCH COAST NORTH SEA	NL
DUTCH EAST AFRICA	ZZ
DUTCH EAST INDIES	ID
DUTCH E INDIES	ID
DUTCH GUIANA	SR
DUTCH GUIANA INTERIOR OF SURINAM	SR
DUTCH GUIANA SURINAM	SR
DUTCH GUIANA VENEZUELA	ZZ
DUTCH GUINEA	ID
DUTCH NEW GUIN	ID
DUTCH NEW GUINEA	ID
DUTCH N G	ID
DUTCH N GUIN	ID
DUTCH N GUINEA	ID
DUTCH WEST INDIES	ZZ
DUTCH W I	ZZ
DUTCH W INDIES	ZZ
D WEST INDIES	ZZ
D WEST INDIES SANTO DOMINGO	DO
DWI	ZZ
D W I	ZZ
D W I DANISH WEST INDIES	VI
D W INDIA	ZZ
D W INDIES	ZZ
DZA	DZ
E AFR	ZZ
E AFRICA	ZZ
E AFRICAN COAST	ZZ
E AFRICA SOMALILAND POSSIBLY	ZZ
E ALGERIA	DZ
E ANGOLA	AO
E ARABIA	ZZ
E ARU IS	ID
EAST AFRICA	ZZ
EAST AFRICA KENYA	KE
EAST AFRICA KENYA OR TANZANIA	ZZ
EAST AFRICA KENYA TANZANIA	ZZ
EAST AFRICA TANGANYIKA	TZ
EAST ASIA	ZZ
EAST ATLANTIC	ZZ
EAST AUSTRALIA	AU
EAST BIMINI	BS
EAST BOLIVIA	BO
EAST BRAZIL	BR
EAST BURMA	MM
EAST CELEBES	ID
EAST CENT D N GUINEA	ID
EAST CENT NEW GUINEA	PG
EAST CENTRAL SYRIA	SY
EAST CHINA	CN
EAST CHINA SEA	ZZ
EAST COAST NEW GUINEA	PG
EAST COAST OF BARBADOS B W I	BB
EAST COAST OF CEYLON	LK
EAST COAST OF MADAGASCAR	MG
EAST COAST OF ST VINCENT B W I	VC
EAST CONGO	ZZ
EAST CUBA	CU
EAST ECUADOR	EC
EASTER ECUADOR	EC
EASTER I	CL
EASTER IS	CL
EASTER ISL	CL
EASTER ISLAND	CL
EASTERN AFRICA	ZZ
EASTERN ASIA	ZZ
EASTERN AUSTRALIA	AU
EASTERN BELG CONGO	CD
EASTERN BRAZIL	BR
EASTERN CAPE	ZA
EASTERN CARIBBEAN	ZZ
EASTERN CENTRAL ATLANTIC	ZZ
EASTERN CENTRAL PACIFIC	ZZ
EASTERN CONGO	ZZ
EASTERN ECUADOR	EC
EASTERN EGYPT	EG
EASTERN EUROPE	ZZ
EASTERN HIMALAYAS	ZZ
EASTERN INDIA	IN
EASTERN KAVANGO NAMIBIA	NA
EASTERN MADAGASCAR	MG
EASTERN MEXICO	MX
EASTERN MONGOLIA	MN
EASTERN NIGERIA	NG
EASTERN NORTH AMERICA	ZZ
EASTERN PACIFIC	ZZ
EASTERN PAKISTAN	PK
EASTERN PANAMA	PA
EASTERN PERSIA	ZZ
EASTERN PERU	PE
EASTERN PRUSSIA	ZZ
EASTERN THAILAND	TH
EASTERN TROPICAL	ZZ
EASTERN TROPICAL AMERICA	ZZ
EASTERN TURKEY	TR
EASTERN UNITED STATES	US
EASTERN UNITED STATES U S A	US
EASTERN US	US
EASTERN VENEZUELA	VE
EAST FINMARK NORWAY	NO
EAST GERMANY	DE
EAST GREENLAND	GL
EAST ICELAND	IS
EAST INDIA	IN
EAST INDIAN ISLANDS	ZZ
EAST INDIES	ZZ
EAST IRAN	IR
EAST KENIA	KE
EAST MADAGASCAR	MG
EAST MALAYSIA	MY
EAST OF AUSTRALIA	AU
EAST OF BORNEO	ZZ
EAST OF CELEBES	ID
EAST OF GREENLAND	GL
EAST OF ICELAND	IS
EAST OF JAPAN	JP
EAST OF JAVA	ID
EAST OF NEW IRELAND	PG
EAST OF NEW ZEALAND	NZ
EAST OF S NEW IRELAND	PG
EAST OF SOUTH NEW IRELAND	PG
EAST OF SPAIN	ES
EAST OF SUMATRA	ID
EAST PAKISTAN	PK
EAST PANAMA	PA
EAST PATAGONIA	AR
EAST PERSIA	ZZ
EAST PERU	PE
EAST POLYNESIA	PF
EAST PRUSSIA	ZZ
EAST RUSSIA	RU
EAST SIBERIA	RU
EAST SIDE OF BARBADOS B W I	BB
EAST SUMATRA	ID
EAST TIBET	CN
EAST TIMOR	TL
EAST TIMOR TIMOR LESTE	TL
EAST TURKESTAN	ZZ
EAST TURKEY	TR
EAUSTRALIA	AU
E AUSTRALIA	AU
E AUSTRIA	AT
E BELGIAN CONGO	CD
E BHUTAN	BT
E BIMINI	BS
EBOLIVIA	BO
E BOLIVIA	BO
E BORDER NEPAL	NP
E BORNEO	ZZ
E BRAZIL	BR
E BR NEW GUINEA	PG
E BURMA	MM
E CAMEROONS	CM
E CANADA	CA
E CANADA UNITED STATES PANAMA	ZZ
E CANARY IS	ES
E CANARY ISLAND	ES
E CAROLINE IS	ZZ
ECAUDOR	EC
EC CF	EC
E C D NEW GUINEA	ID
E C DU NEW GUINEA	ID
E CELEBES	ID
E CELEBES IS	ID
E CEN SUMATRA	ID
E CENT D NEW GUINEA	ID
E CENT MADAGASCAR	MG
E CENTRAL AFRICA	ZZ
E CENTRAL DUTCH NEW GUINEA	ID
E CENTR DU GUINEA	ID
E CENTR DU NEW GUINEA	ID
E CENTR NEW GUINEA	ZZ
E CENTR SUMATRA	ID
E CHINA	CN
E CHINA KOREA	ZZ
E C MADAGASCAR	MG
E COAST MADAGASCAR	MG
E COAST NEW GUINEA	PG
E COAST OF SIAM	TH
E COLOMBIA	CO
E CONGO	ZZ
E CONGO FREE STATE	CD
E CONGO REPUBLIC	ZZ
E COSTA RICA	CR
ECU	EC
ECUA	EC
ECUADOR	EC
ECUADOR COLOMBIA	ZZ
ECUADOR GALAPAGOS ISLANDS	EC
ECUADOR N GRANADA	ZZ
ECUADOR OR COLOMBIA	ZZ
ECUADOR OR PERU	ZZ
ECUADOR PERU	ZZ
ECUADOR QUITO	EC
ECUADOR VENEZUELA	ZZ
E CUBA	CU
ECUDAOR	EC
ECUODOR	EC
E DENMARK	DK
EDINBURGH UK	GB
EDOMINICA	DM
E ECAUDOR	EC
E ECUADOR	EC
E EGYPT	EG
EEKLO BELGIUM	BE
E ERN CENT D NEW GUINEA	ID
E ERN ECUA	EC
EERNEGEM GISTEL BELGIUM	BE
E ERN PAN	PA
E ERN PANAMA	PA
E ERU PANAMA	PA
E ETHIOPIA	ET
E FALKLAND I	FK
E FALKLAND IS	FK
E FIJI IS	FJ
EGEM BELGIUM	BE
E GERM NEW GUINEA	PG
E GER NEW GUINEA	PG
EGIPTE	EG
EGIPTO	EG
E GREENLAND	GL
EGUM IS	PG
EGUM IS E OF TROBRIAND IS	PG
EGY	EG
EGYP	EG
EGYPT	EG
EGYPT ARAB REPUBLIC OF	EG
EGYPTE	EG
ÉGYPTE	EG
EGYPTE PROBABLE	EG
EGYPTIANSUDAN	ZZ
EGYPTIAN SUDAN	ZZ
EGYPTIEN SUDAN	ZZ
EGYPT OR EGY SUDAN	ZZ
EGYPT OR KHARTUM	ZZ
EGYPT OR NUBIA	ZZ
EGYPT PALESTINE	ZZ
EGYPT SUDAN	ZZ
EHIME JAPAN	JP
EHTIOPIA	ET
E I	ZZ
E IND I	ZZ
E INDIA	IN
E INDIES	ZZ
EIRE	IE
EIRE IRELAND	IE
EITREA	ER
E JAVA	ID
E JAVA I	ID
E JAVA IS	ID
E KENYA	KE
EKHO LAKE VESTFOLD HILLS EAST ANTARCTICA	AQ
ELDORADO	US
EL ECUADOR	EC
ELEVAGE	ZZ
EL FAU SUDAN	SD
ELLÁS	GR
ELLICE IS	TV
ELLICE ISLANDS	TV
ELLIGNIES BELGIUM	BE
EL OBEID SUDAN	SD
ELSA	SV
ELSAL	SV
ELSALVADOR	SV
EL SALVADOR	SV
EL SALVADORE	SV
EL SALVADPR	SV
ELSALVATOR	SV
EL SALVODOR	SV
EL SAVADOR	SV
E MADAGASCAR	MG
E MALAY PEN	MY
E MALAY PENIN	MY
E MALAY PENINS	MY
E MALAY PENINSULA	MY
E MALAYSIA	MY
EMBU BRITISH EAST AFRICA	KE
E MESOPOTAMIA	ZZ
E MEXICO	MX
EMIGRATION CANYON SALT LAKE CITY UTAH USA	US
EMIRATOS ÁRABES UNIDOS	AE
EMIRATS ARABES UNIS	AE
ÉMIRATS ARABES UNIS	AE
E MOROCCO	MA
EMPIRE CENTRAFRICAIN RÃPUBLIQUE CENTRAFRICAINE	CF
E NAPAL	NP
ENDERBURY ISLAND	KI
E NEPAL	NP
ENG	GB
ENGANO I	ID
ENGL	GB
ENGLAND	GB
E NGLAND	GB
ENGLAND GREAT BRITAIN	GB
ENGLAND NORTH WALES	GB
ENGLAND OR MACEDONIA	ZZ
ENGLAND SOUTH	GB
ENGLAND UK	GB
ENGLAND U K	GB
ENGLAND U K ENGLISH CHANNEL	GB
ENGLAND U K OR GERMANY OR PORTUGAL	ZZ
ENGLAND UNITED KINGDOM	GB
ENGLAN U K	GB
ENGLISH	GB
ENGLISH CHANNEL	GB
ENGLISH CHANNEL ENGLAND U K	GB
ENGLISH COAST	GB
E NIGERIA	NG
ENIWETOK ATOLL	MH
E NORTH AMERICA	ZZ
E OF AUSTR	AU
E OF AUSTRALIA	AU
E OF AUSTRALIAN	AU
E OF BORNEO	PG
E OF CELEBES	ID
E OF CELEBES IS	ID
E OF E AUSTRALIA	AU
E OF GER NEW GUINEA	PG
E OF JAPAN	JP
E OF JAVA	ID
E OF MOLUCCA IS	ID
E OF N BORNEO	ZZ
E OF NEW BRITAIN	PG
E OF NEW GUINEA	PG
E OF NEW GUINEA BISMARCK ARCHIP	PG
E OF NEW IRELAND	PG
E OF N GUINEA	ZZ
E OF PALESTINE	PS
E OF S NEW IRELAND	PG
E OF S NEW IRELAND IS	PG
E OF SOMALILAND	SO
E OF SPAIN	ES
E OF SUMATRA	ID
E OF TIMOR	ID
E PAKISTAN	PK
E PANAMA	PA
E PARAGUAY	PY
E PERSIA	ZZ
E PERSIA BALUCHISTAN	ZZ
E PERU	PE
EPHESUS TURKEY	TR
EPIRUS GREECE	GR
EPOLYNESIA	PF
E POLYNESIA	PF
E POLYNESIA SOCIETY IS	PF
E PRUSSIA	ZZ
EQ GUINEA	GQ
EQUADOR	EC
EQUAT AFRICA	ZZ
EQUATEUR	EC
ÉQUATEUR	EC
EQUATEUR OU COSTA RICA	ZZ
EQUAT GUINEA	GQ
EQUATORIAL AFRICA	ZZ
EQUATORIALGUINEA	GQ
EQUATORIAL GUINEA	GQ
EQUATORIAL PACIFIC	ZZ
EQUITORIAL GUINEA	GQ
EQYPT	EG
ERI	ER
ERITHREA	ER
ERITREA	ER
ERNAKULUM INDIA	IN
E ROMANIA	RO
ERQUELINES BELGIUM	BE
E RUSSIA	RU
ERYTHRÃE	ER
ERYTHREE	ER
ERYTHRÉE	ER
ÉRYTHRÉE	ER
E S AUSTRALIA	AU
ESBJERG DENMARK	DK
E SCOTLAND	GB
ESH	EH
E SIAM	TH
E SIBERIA	RU
ESLOVAQUIA	SK
ESLOVENIA	SI
ESLOVÈNIA	SI
E SOCIETY IS	PF
E SOKOTRA I	YE
E SOLOMON IS	SB
ESP	ES
ESPAÃA	ES
ESPAGNE	ES
ESPAÑA	ES
ESPANHA	ES
ESPANJA (ES)	ES
ESPANYA	ES
ESSLINGEN GERMANY	DE
EST	EE
ESTADOS UNIDOS	US
ESTADOSUNIDOSDAAMÉRICA	US
ESTADOS UNIDOS DA AMÉRICA	US
ESTADOS UNIDOS DE AMÉRICA	US
ESTATS UNITS D AMÈRICA	US
ESTHONIA	EE
ESTILL KENTUCKY UNITED STATES	US
ESTONIA	EE
ESTONIA LATVIA	ZZ
ESTONIA LATVIA LITHUANIA	ZZ
ESTONIA USSR	EE
ESTONIE	EE
E SUMATRA	ID
E SWEDEN	SE
ET ABESSINIE	ET
ÉTATS FÉDÉRÉS DE MICRONÉSIE	FM
ETATS UNIS	US
ÉTATS UNIS	US
ETATS UNIS D AMÉRIQUE	US
ETH	ET
E THIBET	CN
ETHIOPA	ET
ETHIOPIA	ET
ETHIOPIA CAPTIVE	ET
ETHIOPIA ERITREA	ZZ
ETHIOPIA KENYA	ZZ
ETHIOPIAN KENYA BORDER	ZZ
ETHIOPIE	ET
ÉTHIOPIE	ET
ETHIOPIE CENTRALE	ET
ETHIOPIE NORDEST RÃGION DU GONDAR	ET
ETHIOPIE VALLÃE DE LAWASH	ET
ETHIOPIS BRITISH EAST AFRICA	ET
ETHIOPOA	ET
ETHIPOIA	ET
E TIBET	CN
ETIOPÍA	ET
ETIÒPIA	ET
E TRANSVAAL	ZA
E TUNESIA	TN
E TURKESTAN	ZZ
E U A	US
EUADOR	EC
EUCADOR	EC
EU FRANCE	FR
E UNITED STATES	US
EUPHRATES	ZZ
EURASIA	ZZ
EURASIEN	ZZ
EUROPA	ZZ
EUROPE	ZZ
EUROPEAN	ZZ
EUROPE BY INFE	ZZ
EUROPE BY INFERENCE	ZZ
EUROPE SEPTENTRIONALE	ZZ
EURX	ZZ
E U S A	US
EVIAN CACHAT SPRING FRANCE	FR
EVIDENTLY BRITISH NEW GUINEA	PG
E W MADAGASCAR	MG
EX BRITISH CENTRAL NEW GUINEA	PG
EX BRITISH GUIANA GUYANA	GY
EXETER UK	GB
EXICO	MX
EXT ILLEG N MADAGASCAR	MG
EXTRÊME ORIENT	ZZ
EXTREME SOUTHERN PORTUGAL	PT
EX URSS	ZZ
FAEROE IS	FO
FAEROE ISL	FO
FAEROE ISLANDS	FO
FAEROE ISLANDS DENMARK	FO
FAEROES	FO
FAEROES IS	FO
FAIRFAX ISLAND	AU
FAIR I	GB
FALKLAND I	FK
FALKLAND IDS	FK
FALKLAND ÎLES MALVINAS	FK
FALKLAND IS	FK
FALKLAND ISL	FK
FALKLAND ISLAND	FK
FALKLAND ISLANDS	FK
FALKLAND ISLANDS AND DEPENDENCIES	FK
FALKLAND ISLANDS BRITISH OVERSEAS TERRITORIES	FK
FALKLAND ISLANDS ISLAS MALVINAS	FK
FALKLAND ISLANDS MALVINAS	FK
FALKLAND ISLE	FK
FALKLANDS	FK
FANNING I	KI
FANNING IS	KI
FAR E ISLANDS	FO
FAROE	FO
FAROE IS	FO
FAROE ISLANDS	FO
FAROE ISLANDS EB	FO
FAROER I	FO
FAROES	FO
FAROES IS	FO
FARQUHAR GROUP	SC
FARQUHAR ISLANDS	SC
FAUQUIER COUNTY VIRGINIA USA	US
F CAMEROON	CM
F E A	DJ
F E AFRICA	DJ
FEDERAL DEMOCRATIC REPUBLIC OF ETHIOPIA	ET
FEDERAL REPUBLI	ZZ
FEDERAL REPUBLIC GERMANY	DE
FEDERAL REPUBLIC OF GERMANY	DE
FEDERAL REPUBLIC OF NIGERIA	NG
FEDERATED STATE OF MICRONESIA	FM
FEDERATED STATES MICONESIA	FM
FEDERATED STATES OF	FM
FEDERATED STATES OF MICONESIA	FM
FEDERATED STATES OF MICRONESIA	FM
FEDERATED STATES OF MICRONESIA CAROLINE ISLANDS	FM
FEDERATED STATES OF MICRONESIA PALAU	ZZ
FÉDÉRATION DE RUSSIE	RU
FEDERATION OF ST KITTS AND NEVIS	KN
FEDERATIVE REPUBLIC OF BRAZIL	BR
FED MALAY STATES	MY
FED MALAY STRAIT	ZZ
FED STATE MICRONESIA	FM
FEDSTATES OF MICRONESIA	FM
FED ST MICRONESIA	FM
FEEFS OF SAWAKIN RED SEA	SD
FENI I	PG
FERGUSSON I	PG
FERNADNO PO I	GQ
FERNANDO DE NORONHA AND ROCAS	BR
FERNANDO PO	GQ
FERNANDO P O	GQ
FERNANDO PO I	GQ
FERNANDO PO IS	GQ
FERNANDO POO	GQ
FEROE I	FO
FÉROÉ ÎLES	FO
F FINLAND	FI
F GUI	GF
F GUIANA	GF
FIDJI	FJ
FIDJI I	FJ
FIGI	FJ
FIGI IS	FJ
FIGI ISLANDS	FJ
FIIJ	FJ
FIJI	FJ
FIJI GROUP	FJ
FIJI I	FJ
FIJI IS	FJ
FIJI I S	FJ
FIJI ISLAND	FJ
FIJI ISLANDS	FJ
FIJI ISLAND S	FJ
FIJI ISLANT	FJ
FIJI OR WEST PACIFIC	ZZ
FIJI PACIFIC OCEAN	FJ
FIJIS	FJ
FIJI SOUTH PACIFIC	FJ
FIJI TONGA GROUPS	ZZ
FILIPINAS	PH
FILIPINES	PH
F ILLEG TUNA I	WF
FIN	FI
FINISTÃRE FRANCE	FR
FINL	FI
FINLAND	FI
FINLANDE	FI
FINLANDIA	FI
FINLÀNDIA	FI
FINLAND OR SWEDEN	ZZ
FINLAND SUOMI	FI
FINNISH LAPLAND FINLAND	FI
FINNLAND	FI
FISHING BANKS	ZZ
FIYI	FJ
FJI	FJ
FJORDS NORWAY	NO
FLANNAN ISLES SCOTLAND	GB
FLETCHER S ICE ISLAND	ZZ
FLK	FK
FLOREFFE	BE
FLORES	ZZ
FLORES I	ZZ
FLORES IS	ZZ
FLORIDA	US
FLORIDA EVERGLADES USA	US
FLORIDA STRAITS	US
FLORIDA USA	US
FORM	TW
FORMER USSR	ZZ
FORMER U S S R	ZZ
FORMOSA	TW
FORMOSA IS	TW
FORMOSA JAPAN	ZZ
FORMOSA OR PHILIPPINES	ZZ
FORMOSA TAIWAN	TW
FORMOSA TAIWAN CENTRAL	TW
FORMOSA TAWAIN	TW
FOROYAR	FO
FORT PRINCE OF WALES HUDSON BAY CANADA	CA
FOTUNA I	WF
FPOLYNESIA	PF
FRA	FR
FRA FG	ZZ
FRA FS	ZZ
FRA NC	ZZ
FRANÇA	FR
FRANCE	FR
FRANCE ATLANTIC OCEAN	FR
FRANCE FRANKRIJK	FR
FRANCE FRENCH REPUBLIC	FR
FRANCE NETHERLANDS	ZZ
FRANCE OR GERMANY	ZZ
FRANCE OR SPAIN	ZZ
FRANCE PROGIL LAB	FR
FRANCE SPAIN	ZZ
FRANCE SUISSE	ZZ
FRANCE SW	FR
FRANCIA	FR
FRANCONÉSIE	ZZ
FRANEC	FR
FRANKCE	FR
FRANKLIN CITY CHESAPEAKE BAY USA	US
FRANKLIN OHIO UNITED STATES	US
FRANKREICH	FR
FRANKRIJK	FR
FRÃVENT FRANCE	FR
FR CAMEROON	CM
FR CONGO	ZZ
FR CONGO AFRICA	ZZ
FR CONGO GABOON	GA
FRDERIKSBERG COPENHAGEN DENMARK	DK
FREEHOLD NEW YERSEY USA	US
FREE STATE CONGO	CD
FREIBURG GERMANY	DE
FREISING GERMANY	DE
FRENCH AFRICA	ZZ
FRENCH ANTARCTIC TERRITORY	AQ
FRENCH CAMERON	CM
FRENCH CAMEROON	CM
FRENCH CAMEROONS	CM
FRENCH CAMEROONS CAMEROON	CM
FRENCH CAMEROUN	CM
FRENCH CONGO	ZZ
FRENCH CONGO CENT AFRICAN REP	CF
FRENCH CONGO CONGO BR	CG
FRENCH EQ AFRICA	ZZ
FRENCH EQUAT AFRICA	ZZ
FRENCH EQUATORIAL AFRICA	ZZ
FRENCHGUIANA	GF
FRENCH GUIANA	GF
FRENCH GUIANA BRAZ	ZZ
FRENCH GUIANA BRAZIL	ZZ
FRENCH GUIANA FRANCE	GF
FRENCH GUIANA FRENCH GUIANA	GF
FRENCH GUIANA S A	GF
FRENCH GUINEA	GF
FRENCH GUINEA S A	GF
FRENCH GUYANA	GF
FRENCH INDOCHINA	ZZ
FRENCH INDO CHINA	ZZ
FRENCH MIDDLE CONGO	ZZ
FRENCH MOROCCO	MA
FRENCH N W AFRICA	ZZ
FRENCH POLYNESIA	PF
FRENCH POLYNESIA MARQUESAS ISLANDS	PF
FRENCH POLYNESIA PACIFIC OCEAN	PF
FRENCH REPUBLIC	FR
FRENCH SOMALILAND	DJ
FRENCH SOUDAN	ML
FRENCH SOUTHERN AND ANTARCTIC LANDS	TF
FRENCH SOUTHERN AND ANTARCTIC TERRITORIES	TF
FRENCH SOUTHERN TERRITORIES	TF
FRENCH SUDAN	ML
FRENCH SUDAN NIGER	NE
FRENCH W AFRICA	ZZ
FRENCH WEST AFRICA	ZZ
FRENCH WEST AFRICA NIGERIA	NG
FRENCH WEST INDIES	ZZ
FR EQUAT AFRICA	ZZ
FR EQUATORIAL AFR	ZZ
FR EQUATORIAL AFRICA	ZZ
FRESNO COUNTY CALIFORNIA USA	US
FRG	ZZ
FRGU	GF
FR GUIANA	GF
FR GUIANA OR D GUIANA	ZZ
FRIJI IS	FJ
FR INDO CHINA	ZZ
FRMARQUESAS ISLANDS	PF
FRNCE	FR
FRO	FO
FROM EITHER ATLANTIC OR INDIAN OCEAN	ZZ
FROM KUISHAN ISLAND OF TAIWAN	TW
FRONTIER OF SIAM	TH
FR POLYNESIA	PF
FR SOMALILAND	SO
FR SUDAN	ML
FR W AFRICA	ZZ
FR W AFRICA GABOON	GA
FR W AFRICA SUDAN	SD
FR WEST AFRICA	ZZ
FR W TURKESTAN	ZZ
FRYDEKMISTEK CZECHOSLOVAKIA	CZ
FRYDEKMISTEK CZECH REPUBLIC	CZ
F S CONGO	CD
FSM	FM
FTVALLEY USA	US
FUENTEVENTURA	ES
FUERTEVENTURA	ES
FUJI	FJ
FUJI IS	FJ
FULANGA I	FJ
FUTUNA	WF
FUTUNA I	WF
FUZHOU CHINA	CN
F W AFRICA	ZZ
GAB	GA
GABON	GA
GABÓN	GA
GABON CONGO	ZZ
GABONESE REPUBLIC	GA
GABON OR LIBERIA	ZZ
GABON OU CONGO	ZZ
GABOON	GA
GABOON FR CONGO	GA
GABOR	GA
GALAPAGO I	EC
GALAPAGO IS	EC
GALAPAGOS	EC
GALAPAGOS ARCH	EC
GALAPAGOS ARCHIPELAGO	EC
GALAPAGOS ARCHIPELAGO ECUADOR	EC
GALAPAGOS I	EC
GALAPAGOS IDS	EC
GALAPAGOS IS	EC
GALAPAGOS ISLAND	EC
GALAPAGOSISLANDS	EC
GALAPAGOS ISLANDS	EC
GALAP IS	EC
GALAPOGOS	EC
GALAPOGOS ISLANDS	EC
GAL EX	EC
GALICIA	ES
GALPAGOS	EC
GALPAGOS ISLANDS	EC
GAMBIA	GM
GAMBIA GUINEA SENEGAL	ZZ
GAMBIA RIVER	ZZ
GAMBIA SENEGAL	ZZ
GAMBIA THE	GM
GAMBIA WEST	GM
GAMBIA WEST AFRICA	GM
GAMBIE	GM
GAMBIER ISL	CA
GAMBIER ISLAND	ZZ
GAMBIER ISLANDS	PF
GANSU REPUBLIC OF CHINA	CN
G API I	ID
GARDNER ISLAND	KI
GARNA	ZZ
GÃTEBORG SWEDEN	SE
GÃTTINGEN GERMANY	DE
GAUTEMALA	GT
GÃVLE SWEDEN	SE
GAZA STRIP	PS
GBR	GB
GDR	ZZ
G E AFRICA	ZZ
GEEL BELGIUM	BE
GEMBLOUX BELGIUM	BE
GENAPPE BELGIUM	BE
GEO	GE
GEORGIA	GE
GEORGIA ATLANTA USA	US
GEORGIAN SOVIET SOCIALIST REPUBLIC	GE
GEORGIA USA	US
GEORGIE	GE
GÉORGIE	GE
GÉORGIE DU SUD	GS
GÉORGIE DU SUD ET LES ÎLES SANDWICH DU SUD	GS
GEORGIE DU SUD I	GS
GEOTHERMAL AREA ICELAND	IS
GER	DE
GERAARDSBERGEN BELGIUM	BE
GER AFRICA	ZZ
GER E AFR	ZZ
GER E AFRICA	ZZ
GER EAST AFRICA	ZZ
GERM	DE
GERMAN AFRICA	ZZ
GERMAN DR NO LONGER EXISTS	DE
GERMAN E AFRICA	ZZ
GERMAN EAST AFRICA	ZZ
GERMAN NEW GUINEA	PG
GERMAN N GUINEA	PG
GERMAN PAPUA NEW GUINEA	PG
GERMAN PAPUA N GUINEA	PG
GERMAN S W AFRICA	NA
GERMAN SW AFRICA	NA
GERMANY	DE
GERMANY CAPTIVE	DE
GERMANY DEUTSCHLAND	DE
GERMANY DEUTSCHLAND ALLEMAGNE	DE
GERMANY EAST	DE
GERMANY EAST GERMANY	DE
GERMANY E PRUSSIA	ZZ
GERMANY FEDERAL REPUBLIC OF	DE
GERMANY OR FRANCE	ZZ
GERMANY OR POLAND	ZZ
GERMANY POLAND	ZZ
GERMANY WEST	DE
GERMANY WEST GERMANY	DE
GERMAY	DE
GERM D NEW GUINEA	PG
GERM E AFRICA	ZZ
GERM NEW GUINEA	PG
GERM N GUINEA	PG
GER NEW GUINEA	PG
GER NEW GUINEA N COAST	PG
GER W AFRICA	ZZ
GEYSIR ICELAND	IS
GGY	GG
GHA	GH
GHAILAND	TH
GHANA	GH
GHANA EASTERN REGION	GH
GHANA LIBERIA	ZZ
GHANA TOGO	ZZ
GHENT BELGIUM	BE
GIB	GI
GIBRALTAR	GI
GIBRALTAR BRITISH OVERSEAS TERRITORIES	GI
GIBRALTER	GI
GIESSEN GERMANY	DE
GIJZENZELE BELGIUM	BE
GILBERT ELLICE IS	ZZ
GILBERT IS	KI
GILBERT ISLAND	KI
GILBERT ISLANDS	KI
GIN	GN
GIPPSLAND NEW ZEALAND	NZ
GISHA BURUNDI	BI
GLORIOSO ISLAND	TF
GLORIOSO ISLANDS	TF
GLP	GP
GMB	GM
GNB	GW
GNOWANGERUP WEST AUSTRALIA	AU
GNQ	GQ
GOA	IN
G OF GUINEA	ZZ
GOLD COAST	GH
GOLD COAST AFRICA	GH
GOLD COAST GHANA	GH
GOLD COAST HINT	GH
GOLD COAST HINTER	GH
GOLD COAST HINTERLAND	GH
GOLD COAST HUNTERLAND	GH
GOLD COAST INTERIOR	GH
GOLFE ARABIQUE	ZZ
GOLFE D ADEN	ZZ
GOLFE D ALASKA	ZZ
GOLFE D ALEXANDRETTA	ZZ
GOLFE D AQABA	ZZ
GOLFE DE BOHAI	ZZ
GOLFE DE BURTON	ZZ
GOLFE DE CALIFORNIE	ZZ
GOLFE DE CARPENTARIE	ZZ
GOLFE DE GABES	ZZ
GOLFE DE GAETE	ZZ
GOLFE DE GASCOGNE	ZZ
GOLFE DE GENES	ZZ
GOLFE DE GUINEE	ZZ
GOLFE DE L ALASKA	ZZ
GOLFE DE LA PATIENCE	ZZ
GOLFE DE PANAMA	ZZ
GOLFE DE SMYRNE	ZZ
GOLFE DE TADJOURA	ZZ
GOLFE DE THESSALONIKI	ZZ
GOLFE DE TUNIS	ZZ
GOLFE D OMAN	ZZ
GOLFE DU BENGALE	ZZ
GOLFE DU BENIN	ZZ
GOLFE DU MEXIQUE	ZZ
GOLFE DU SIAM	ZZ
GOLFE DU TONKIN	ZZ
GOLFE EVOIKOS	ZZ
GOLFE EVOIKOS DU NORD	ZZ
GOLFE EVOIKOS SUD	ZZ
GOLFE IBERO MAROCAIN	ZZ
GOLFE PERSIQUE	ZZ
GONTRODE BELGIUM	BE
GOODENOUGH I	PG
GOODENOUGH IS	PG
GORAM IS	ID
GOROM I	ID
GOROM IS	ID
GOROM LAUT	ID
GOROM LAUT IS	ID
GOSSELIES BELGIUM	BE
GOTLAND	SE
GOUGH	SH
GOUGH I	SH
GOUGH ISLAND ST HELENA DEPENDENCY TRISTAN DA CUNHA ISLAND GROUP BRITISH OVERSEAS TERRITORY	SH
GRANADA	GD
GRAN CANARY I	ES
GRAND BAHAMA IS	BS
GRAND BAHAMA ISLAND	BS
GRAND BANKS	CA
GRAND CANARY IS	ES
GRAND CAYMAN	KY
GRAND CAYMAN B W I	KY
GRAND CAYMAN I	KY
GRAND COMORO I	KM
GRAND DUCHÉ DE LUXEMBOURG GROßHERZOGTUM LUXEMBURG GROUSSHERZ	LU
GRAND DUCHÉ DE LUXEMBOURG GROUSSHERZOGTUM LËTZEBUERG GROßHER	LU
GRAND DUCHY OF LUXEMBOURG	LU
GRANDE BRETAGNE	GB
GRANDE COMORE	KM
GRAND NAMAQUOIS	ZZ
GRC	GR
GR CANARY I	ES
GR CANARY IS	ES
GR COMORO I	KM
GRD	GD
GRE	ZZ
GREAT BANDA	ID
GREAT BANDA I	ID
GREAT BANDA IS	ID
GREAT BAY ESTUARY	US
GREAT BRITAIN	GB
GREAT BRITAIN ENGLAND U K	GB
GREAT BRITIAN	GB
GREATER ANTILLES	ZZ
GREATER SANGHIR	ID
GREAT NATUNA I	ID
GREAT NATUNA IS	ID
GREAT NATUNA I S	ID
GREAT NEWFOUNDLAND BANKS	CA
GREAT NICOBAR I	IN
GREAT NICOBAR IS	IN
GREAT SALT LAKE UTAH USA	US
GREAT SALVAGE I	PT
GREAT SANGI I	ID
GRECE	GR
GRÈCE	GR
GRECIA	GR
GRÈCIA	GR
GREECE	GR
GREECE ELLÁDA	GR
GREECE GRÈCE GRIEKENLAND	GR
GREECE MOST LIKELY	GR
GREEK ARCHIPELGO	GR
GREEKS	GR
GREELAND	GL
GREEN I	ZZ
GREENL	GL
GREENLAND	GL
GREENLAND CANADA	ZZ
GREENLAND DENMARK	GL
GREENLAND N E	GL
GREENLAND NORTH EAST	GL
GREENLAND OR LABRADOR	ZZ
GREENLAND SEA	ZZ
GRENADA	GD
GRENADA GRENADINES	VC
GRENADA OR BARBADOS	ZZ
GRENADA W I	GD
GRENADE	GD
GRENADINE ISLANDS	VC
GRENADINES	VC
GRENADINES BRITISH WEST INDIES	VC
GRENADINES B W I	VC
GRENOBLE FRANCE	FR
GRIFFIN USA	US
GRIGNON FRANCE	FR
GR KEY IS	ID
GRL	GL
GR NATUNA I	ID
GR NATUNA IS	ID
GROENLAND	GL
GROENLANDIA	GL
GRONLAND WEST GREENLAND	GL
GR SANGI	ID
GT BANDA I BANDA IS	ID
GT BANDA IS	ID
GT BRITAIN GERMANY OR UNKNOWN	ZZ
GT KEY IS	ID
GTM	GT
GT NATUNA I	ID
GT NATUNA IS	ID
GT NATUNI	ID
GT NICOBAR I	IN
GT NICOBAR IS	IN
GT REDANG I	MY
GT SANGI I	ID
GUA	GT
GUADALCANAL	SB
GUADALOUPE	GP
GUADALUPE	GP
GUADALUPE IS	MX
GUADALUPE ISLAND	MX
GUADAMALA	GT
GUADELOPE	GP
GUADELOUP	GP
GUADELOUPE	GP
GUADELOUPE FR LESSER ANTILLES	GP
GUADELOUPE I	GP
GUADELOUPE ISLAND	GP
GUAM	GU
GUÃMÃNÃ FRANCE	FR
GUAM I	GU
GUAM IS	GU
GUAM MARIANUS	GU
GUANA BVI	VG
GUANA ISLAND	VG
GUANAJUATO MEXICO	MX
GUANGDONG	CN
GUARTEMALA	GT
GUAT	GT
GUATAMALA	GT
GUATELMALA	GT
GUATEMALA	GT
GUATÉMALA	GT
GUATEMALA CITY	GT
GUATEMALA MEXICO	ZZ
GUATEMALA MEXICO NICARAGUA	ZZ
GUATEMALA OR PANAMA OR COLOMBIA	ZZ
GUATEMALA OU MEXIQUE	ZZ
GUATEMALA PANAMA COLOMBIA	ZZ
GUAYANA	GY
GUAYANA FRANCESA	GF
GUERET FRANCE	FR
GUERNESEY	GG
GUERNSEY	GG
GUERNSEY UK	GG
GUF	GF
GUIANA	GY
GUIANA BRAZIL	ZZ
GUIANA FRANCESA	GF
GUIANA GUYANA	GY
GUIANAS	ZZ
GUIANA TRINIDAD	ZZ
GUINÃE	GN
GUINÃECONAKRY	GN
GUINÃE CONAKRY	GN
GUINÃE CONAKRY RÃG FOUTADJALLON	GN
GUINEA	GN
GUINEA BISSAU	GW
GUINEA COAST	GN
GUINEA ECUATORIAL	GQ
GUINEA EQUATORIAL	GQ
GUINÉ BISSAU	GW
GUINEE	GN
GUINÉE	GN
GUINÉE BISSAO	GW
GUINEE BISSAU	GW
GUINÉE BISSAU	GW
GUINÉE CONAKRY	GN
GUINEE EQUATORIALE	GQ
GUINÉE ÉQUATORIALE	GQ
GUINÉE ESPAGNOLE	GQ
GUINÉE FRANÇAISE	GN
GUINÉE PORTUGAISE	GW
GULF OF ADEN	ZZ
GULF OF ALASKA	US
GULF OF GUINEA	ZZ
GULF OF MAINE, CANADA	CA
GULF OF MEXICO	ZZ
GULF OF OMAN	ZZ
GULF OF PANAMA	ZZ
GULF OF PERSIA	ZZ
GULF OF PETER THE GREAT SEA OF JAPAN RUSSIA	RU
GULF OF ST LAWRENCE	CA
GULF OF THAILAND	ZZ
GULF OF VENEZUELA	VE
GUM	GU
GUMMA JAPAN	JP
GUNONG API	ID
GUT	GT
GUY	GY
GUYA	GY
GUYANA	GY
GUYANA BRAZIL	ZZ
GUYANA BRITISH GUIANA	GY
GUYANA S AMERICA	GY
GUYANA VENEZUELA	ZZ
GUYANE	GF
GUYANE BRÉSIL	ZZ
GUYANE BRITANNIQUE	GY
GUYANE FRANCAISE	GF
GUYANE FRANÇAISE	GF
GUYANE OU BRÉSIL	ZZ
GY NATUNA IS	ID
HAÃTI	HT
HABAY LA NEUVE BELGIUM	BE
HADERSLEV JETLAND DENMARK	DK
HAI	HT
HAIMA BUNYORO NORTH UGANDA	UG
HAINAN	CN
HAINAN IS	CN
HAINAN ISLAND	CN
HAINAULT BELGIUM	BE
HAIT	HT
HAITI	HT
HAITÍ	HT
HAÏTI	HT
HAITI AND DOMINICAN REPUBLIC	ZZ
HAITI AND PANAMA	ZZ
HAITI DOMINICAN REPUBLIC OR CUBA	ZZ
HAITI OR DOMINICAN REPUBLIC	ZZ
HALLE BELGIUM	BE
HALMAHERA	ID
HALMAHERA ISLAND	ID
HALMSTAD SWEDEN	SE
HAMME BELGIUM	BE
HAMMEMILLE BELGIUM	BE
HANNMÃNDEN GERMANY	DE
HANNOVER GERMANY	DE
HARDING KWAZULUNATAL SOUTH AFRICA	ZA
HARROGATE UK	GB
HASHEMITE KINGDOM OF JORDAN	JO
HAUTE GUINÉE FRANÇAISE	GN
HAUTES PYRENEES	FR
HAUTE VOLTA	BF
HAUTRAGE BELGIUM	BE
HAUT RHIN FRANCE	FR
HAVELOCK NORTH NEW ZEALAND	NZ
HAWAÃ	US
HAWAII	US
HAWAIIAN IDS	US
HAWAIIAN IS	US
HAWAIIAN ISL	US
HAWAIIAN ISLANDS	US
HAWAIIAN ISLES	US
HAWAII I	US
HAWAII IS	US
HAWAII ISLES	US
HAWAII USA	US
HAWKSWORTH MERE WEST YORKSHIRE UK	GB
HAYTE	HT
HAYTI	HT
HAYTI HAITI	HT
HAYT ILLEG	HT
HEARD AND MCDONALD ISLANDS	HM
HEARD ET ÎLES MACDONALD ÎLE	HM
HEARD I	HM
HEARD IS	HM
HEARD ISLAND AND MCDONALD ISLANDS	HM
HEBREDES	GB
HEBREDES IS	GB
HEBRIDES	GB
HEBRIDES IS	GB
HEIDELBERG GERMANY	DE
HEILONGJIANG PROVINCE CHINA	CN
HELGOLAND	DE
HELGOLAND I	DE
HELIGOLAND	DE
HELSINKI FINLAND	FI
HENAN SHENG	CN
HENDERSON	PN
HENDERSON I	PN
HENDERSON ISLAND	PN
HENDERSON I S PACIFIC	PN
HENDRY FLORIDA UNITED STATES	US
HERBAL GARDEN KYOTO JAPAN	JP
HERCEGOVINA	BA
HEREDIA	CR
HERFORDSHIRE	GB
HERMISILLO SONORA MEXICO	MX
HERVEY GROUP	AU
HERZEGOVINA	BA
HERZELE BELGIUM	BE
HEVERLEE BELGIUM	BE
HIATI	HT
HIGHLANDS CO	ZZ
HIGH LEBANON	LB
HIGH MNTS OF EUROPE ASIA	ZZ
HIGH SEAS	ZZ
HIMALAYA	ZZ
HIMALAYAN INDIA	IN
HIMALAYAS	ZZ
HIMALAYAS INDIA	IN
HINTERLAND GOLD COAST	GH
HINTERLAND OF GOLD COAST	GH
HIROO TOKYO JAPAN	JP
HIROSHIMA JAPAN	JP
HIRSHOLM DENMARK	DK
HISPANICOLA	ZZ
HISPANIOLA	ZZ
HISPANIOLA DOMINICAN REPUBLIC	DO
HISPANIOLA D R	DO
HISPANIOLA HAITI	HT
HKG	HK
HMD	HM
HND	HN
HOEGAARDEN BELGIUM	BE
HOEK BELGIUM	BE
HÖFUÐBORGARSVÆÐIÐ	IS
HOKKAIDO JAPAN	JP
HOLANDA	NL
HOLARCTIC	ZZ
HOLARCTIC REGION	ZZ
HOLL	NL
HOLLAND	NL
HOLLANDE	NL
HOLLAND NETHERLANDS	NL
HOLSTEIN GERMANY	DE
HOLY LAND	ZZ
HOLY SEE	VA
HOLZMINDEN GERMANY	DE
HONAN CHINA	CN
HOND	HN
HONDURAS	HN
HONDURAS C A	HN
HONDURAS NICARAGUA	ZZ
HONDURAS OR COSTA RICA	ZZ
HONDURAS OR MEXICO	ZZ
HONDURAS PROB	HN
HONDURAS REPUBLIC	HN
HONDURAS SPANISH	HN
HONDURES	HN
HONDUROS	HN
HONDURUS	HN
HONDUURAS	HN
HONGARY	HU
HONGKONG	HK
HONG KONG	HK
HONG KONG ID	HK
HONG KONG ISLAND	HK
HONG KONG SPECIAL ADMINISTRATIVE REGION OF CHINA	HK
HONGRIA	HU
HONGRIE	HU
HONOLULU HAWAII USA	US
HOOPEH	ZZ
HORNE IS	ZZ
HORTICULTURAL CROPS RESEARCH STATION CASTLE HAYNE NORTH CAROLINA USA	US
HOSOGI HIROSHIMA JAPAN	JP
HOT CREEK HATCHERY BISHOP CALIFORNIA	US
HOUGHTON UK	GB
HOWLANDBAKER ISL	UM
HOWLAND IS	UM
HOWLAND ISLAND	UM
HRV	HR
HRVATSKA	HR
H T	ZZ
HTI	HT
HUALIEN CO	TW
HUDDINGE SWEDEN	SE
HUDSON BAY	CA
HUHEHOT MONGOLIA CHINA	MN
HUN	HU
HUNGARIA	HU
HUNGARY	HU
HUNGARY HONGRIE	HU
HUNGARY MAGYARORSZAG	HU
HUNGARY OR FRANCE	ZZ
HUNGARY ROMANIA	ZZ
HUNGRÍA	HU
HVERAGERTHI ICELAND	IS
HYBRID	ZZ
IA	US
IAUSTRIA	AT
IBADAN NIGERIA	NG
IBERIA	ZZ
IBERIA BY INFE	ZZ
IBERIA BY INFERENCE	ZZ
ICE	IS
ICEL	IS
ICELAND	IS
ICELAND NORTH	IS
ICELAND SOUTH OF	IS
IDAHO	US
IDAHO USA	US
ID CF	ID
IDN	ID
IEPER BELGIUM	BE
IFUGAN	ZZ
ÎLE BOUVET	BV
ÎLE CHRISTMAS	ZZ
ILE DE LA DOMINIQUE	DM
ÎLE DE LA DOMINIQUE	DM
ILE DE LA MELANESIE	ZZ
ILE DE LA RÉUNION	RE
ÎLE DE MAN	IM
ILE DE PÂQUES	CL
ILE DE RAIATEA	PF
ILE EUROPA	TF
ILE FIDJI	FJ
ILE GLORIEUSE	FR
ÎLE HEARD	HM
ILE MAURICE	MU
ÎLE MAURICE	MU
ÎLE NORFOLK	NF
ÎLES ÅLAND	AX
ÎLE SALOMON	SB
ILES BALÉARES	ES
ÎLES CAÏMANS	KY
ILES CANARIES	ES
ÎLES COCOS	CC
ILES COMORES	KM
ÎLES COOK	CK
ILES CROZET	TF
ILES DE LA MELANESIE	ZZ
ILES DES MOLUQUES	ZZ
ILES DU CAP VERT	CV
ÎLES FALKLAND	FK
ÎLES FÉROÉ	FO
ILES FIDJI	FJ
ILES GALAPAGOS	EC
ILES GLORIEUSES	TF
ÎLES HEARD ET MACDONALD	HM
ÎLES KEELING	CC
ILES KERGUELEN	TF
ILES LOYAUTE	NC
ÎLES MACDONALD	HM
ÎLES MALOUINES	FK
ILES MARIANNES	ZZ
ÎLES MARIANNES DU NORD	MP
ÎLES MARSHALL	MH
ÎLES MINEURES ÉLOIGNÉES DES ÉTATS UNIS	UM
ILES SALOMON	SB
ÎLES SALOMON	SB
ILES SAMOA	ZZ
ÎLES SANDWICH DU SUD	GS
ILES SEYCHELLES	SC
ILES TONGA	TO
ÎLES TURKS ET CAÏCOS	TC
ILES VIERGES	ZZ
ÎLES VIERGES BRITANNIQUES	VG
ÎLES VIERGES DES ÉTATS UNIS	VI
ILLEG	ZZ
ILLEG CONGO	ZZ
ILLEGIBLE	ZZ
ILLEG MEXICO	MX
ILLEG MOZAMBIQUE	MZ
ILLEG NEW GRENADA	GD
ILLEG W CEYLON	LK
ILLINOIS USA	US
IMN	IM
INA	ZZ
INACCESIBLE ISLAND	SH
INACCESSIBLE I	SH
INACCESSIBLE ISLAND	SH
INADANOBORITO KAWASAKI KANAGAWA JAPAN	JP
INAGUA	ZZ
INA IJ	ZZ
INA TI	ZZ
INCONNU	ZZ
IND	ID
IND	IN
INDE	IN
INDENESIA	ID
INDEPENDENT STATE OF PAPUA NEW GUINEA	PG
INDEPENDENT STATE OF SAMOA	WS
INDES	ZZ
INDES ANGLAISES	ZZ
INDES NEERLANDAISES	ZZ
INDES OCCIDENTALES	ZZ
INDES OCCIDENTALES DANOISES	ZZ
INDES ORIENTALES	ZZ
INDI	ZZ
INDIA	IN
ÍNDIA	IN
INDIA AND ASIA	IN
INDIA ASIA	ZZ
INDIA BANGLADESH	ZZ
INDIA BENGAL	ZZ
INDIA BHARAT GANARAJYA	IN
INDIA BHUTAN	ZZ
INDIA BORDER OF NEPAL	IN
INDIA BRITISH	ZZ
INDIA BURMA	ZZ
INDIA BURMA MYANMAR	ZZ
INDIA CA	IN
INDIA CAPTIVE	IN
INDIA CEYLON	ZZ
INDIA CHINA	ZZ
INDIA EAST TO JAPAN	ZZ
INDIA E NEPAL	ZZ
INDIA INDIAN OCEAN	IN
INDIA IRAN	ZZ
INDIA LOWER BURMA	ZZ
INDIA MYANMAR	ZZ
INDIAN	ZZ
INDIANA	US
INDIANA UNITED STATES	US
INDIA NEPAL	ZZ
INDIAN O	ZZ
INDIAN OCEAN	ZZ
INDIAN OCEAN IS	ZZ
INDIAN OCEAN ISLAND S	ZZ
INDIAN OR ATLANTIC OCEAN	ZZ
INDIAN PENINS	IN
INDIAN SEAS	ZZ
INDIAN TERRITORY	IN
INDIA N W CEYLON	ZZ
INDIA OR AUSTRALIA	ZZ
INDIA OR BURMA	ZZ
INDIA OR CHINA	ZZ
INDIA OR SRI LANKA	ZZ
INDIA OR TIBET	ZZ
INDIA PAKISTAN	PK
INDIA PAKISTAN	ZZ
INDIA PAKISTAN CHINA	ZZ
INDIA PAKISTAN NEPAL	ZZ
INDIA SOUTH	IN
INDIA SRI LANKA	ZZ
INDIA TIBET FRONTIER	IN
INDIA UPP BURMA	ZZ
INDIA UPPER BURMA	ZZ
INDIA W CEYLON	ZZ
INDIA W NEPAL	ZZ
INDIES	ZZ
INDIGENOUS IN WESTERN ASIA	ZZ
INDIO PACIFIC	ZZ
INDO	ZZ
INDOCHINA	ZZ
INDO CHINA	ZZ
INDO CHINA CAMBODIA	KH
INDOCHINA CAMBODIA	KH
INDO CHINA LAOS	LA
INDOCHINA LAOS	LA
INDOCHINE	ZZ
INDODONESIA	ID
INDO MALAISIE	ZZ
INDO MALAY	ZZ
INDO MALAY REGION	ZZ
INDONESDIA	ID
INDONESIA	ID
INDONÈSIA	ID
INDONESIA BORNEO	ID
INDONESIA GT SUNDA	ID
INDONESIA JAVA	ID
INDONESIA MALAYSIA	ZZ
INDONESIAN	ID
INDONESIAN BORNEO	ID
INDONESIA NEW GUINEA ID	ID
INDONESIA NEW GUINEA PAPUA	ID
INDONESIA OR MALAYA	ZZ
INDONESIA OR MALAYSIA	ZZ
INDONESIA OR PAPUA NEW GUINEA	ZZ
INDONESIA PAPUA NEW GUINEA	ID
INDONESIA PAPUA PROVINCE	ID
INDONESIA REPUBLIK INDONESIA	ID
INDONESIA SULAWESI	ID
INDONESIA SUMATRA	ID
INDONESIE	ID
INDONÉSIE	ID
INDONESIEN	ID
INDO PACIFIQUE	ZZ
INDRULAMAN I	ID
INGLATERRA	GB
INLAND CENTER E MADAGASCAR	MG
INLAND E MADAGASCAR	MG
INLAND OF W BR NEW GUINEA	PG
INLAND S E MADAGASCAR	MG
INLAND S W MADAGASCAR	MG
INNER MONGOLIA	MN
INNER OSLO FJORD	NO
INS	ZZ
INT B GUIANA	GY
INT BRIT GUIANA	GY
INT DUTCH GUIANA	SR
INTER BRIT GUIANA	GY
INTER D GUIANA	SR
INTERIOR AUSTRALIA	AU
INTERIOR BR GUIANA	GY
INTERIOR BRIT GUIANA	GY
INTERIORBRIT GUIANA	GY
INTERIOR D GUIANA	SR
INTERIOR D GUIANA SURINAM	SR
INTERIOR GOLD COAST	GH
INTERIOR GUIANA	ZZ
INTERIOR OF BOLIVIA	BO
INTERIOR OF BRIT GUIANA	GY
INTERIOR OF D GUIANA	SR
INTERIOR OF D GUIANA SURINAM	SR
INTERIOR OF GOLD COAST	GH
INTERIOR OF GUIANA	ZZ
INTERIOR OF MOROCCO	MA
INTERIOR OF SURINAM D GUIANA	SR
INTERNATIONAL WATERS	ZZ
I OF CAGAYAN SULU	PH
IOT	IO
IOWA	US
IOWA USA	US
IPANDE	TZ
IPOH MALAYSIA	MY
IRAG	IQ
IRAK	IQ
IRAN	IR
IRÁN	IR
IRAN IRAQ	ZZ
IRAN IRAQ KUWAIT OMAN SAUDI ARABIA UNITED ARAB EMIRATES	ZZ
IRANISLAMICREPUBLICOF	IR
IRAN ISLAMIC REPUBLIC OF	IR
IRAN OR IRAQ	ZZ
IRAN OR USSR	ZZ
IRAN PAKISTAN	ZZ
IRAN RÉPUBLIQUE ISLAMIQUE D	IR
IRAN TURQUIE	ZZ
IRAQ	IQ
IRE	IE
IREL	IE
IRELAND	IE
IRELAND (EIRE)	IE
IRELAND ICELAND	ZZ
IRELAND NORTHERN IRELAND	ZZ
IRIAN JAYA	ID
IRISH REPUBLIC	IE
IRISH SEA	ZZ
IRL	IE
IRLANDA	IE
IRLANDE	IE
IRN	IR
IRQ	IQ
ISABELA PHILIPPINES	PH
ISL	IS
ISLA BOUVET	BV
ISLA DEL COCO	CR
ISLA DE MAN	IM
ISLA DE NAVIDAD	ZZ
ISLA DE PROVIDENCIA	CO
ISLAMIC REPUBLIC OF IRAN	IR
ISLAMIC REPUBLIC OF PAKISTAN	PK
ISLAND	IS
ISLANDE	IS
ISLANDIA	IS
ISLAND OF GUAM	GU
ISLAND OF MARTINIQUE	MQ
ISLANDS OF ECUADOR PERU CHILE	ZZ
ISLAS CAIMÁN	KY
ISLAS COCOS	CC
ISLAS COOK	CK
ISLAS FEROE	FO
ISLAS GALAPAGOS	EC
ISLAS GEORGIAS DEL SUR	GS
ISLAS HEARDY MCDONALD	HM
ISLAS MALVINAS	FK
ISLAS MARIANAS DEL NORTE	MP
ISLAS MARSHALL	MH
ISLAS PITCAIRN	PN
ISLAS SALOMÓN	SB
ISLAS TURCAS Y CAICOS	TC
ISLAS ULTRAMARINAS DE ESTADOS	UM
ISLAS VÍRGENES BRITÁNICAS	VG
ISLAS VÍRGENES ESTADOUNIDENSES	VI
ISLE OF MAN	IM
ISLE OF MULL SCOTLAND UK	GB
ISLE OF PINES	ZZ
ISLE OF SKYE	GB
ISLES OF SCILLY	GB
ISL OF SKYROS	GR
IS OF DOMINICA	DM
IS OF DOMINICA	DO
ISOLATED AT TORRY RESEARCH STATION CAUGHT OFF THE NORTH CAPE OF NORWAY	NO
IS PIFORE	ZZ
ISR	IL
ISRA	IL
ISRAÃL	IL
ISRAEL	IL
ISRAËL	IL
ISRAEL FORMERLY PALESTINE	IL
ISRAEL (IL)	IL
ISRAEL JORDAN	ZZ
ISRAEL JORDAN PALESTINE	ZZ
ISRAEL LEBANON SYRIA TURKEY	ZZ
ISRAEL OR JORDON	ZZ
ISRAEL PALESTINE	ZZ
ISREAL	IL
ITA	IT
ITAL	IT
ITALIA	IT
ITÀLIA	IT
ITALIA (IT)	IT
ITALIAN ABYSSINIA	ZZ
ITALIAN COAST	IT
ITALIAN REPUBLIC	IT
ITALIAN SOMALILAND	SO
ITALIAN SOMILILAND	SO
ITALIE	IT
ITALIE ITALY ITALIA	IT
ITALY	IT
ITALY CENTRAL	IT
ITALY ITALIA	IT
ITALY N	IT
ITALY NORTH	IT
ITALY NORTH AFRICA	ZZ
ITALY PP	IT
ITHACA USA	US
ITURI LES BAHEMA ZAÃRE	CD
ITURI ZAÃRE	CD
ITYOP'IYA	ET
IVORY COAST	CI
IVORY COST	CI
IWATA JAPAN	JP
IZU ISLANDS	JP
JACKSONVILLE ZOO	US
JAKARTA INDONESIA	ID
JAM	JM
JAMA	JM
JAMACIA	JM
JAMAICA	JM
JAMAICA IS	JM
JAMAICA PUERTO RICO	ZZ
JAMAICA WEST INDIES	JM
JAMAICA W I	JM
JAMAÏQUE	JM
JAMAIQUE JAMAICA	JM
JAMCAICA	JM
JAMIACA	JM
JAMPEA I	ID
JAMPEA IS	ID
JANIOLLE BELGIUM	BE
JÃNKÃPING SWEDEN	SE
JAN MAYEN	SJ
JAP	JP
JAPAN	JP
JAPAN CENT FORMOSA	TW
JAPAN CENTRAL	JP
JAPAN CENTR FORMOSA	TW
JAPAN FORMOSA	TW
JAPAN KOREA	ZZ
JAPAN N FORMOSA	TW
JAPAN NIPPON	JP
JAPAN OKINAWA	JP
JAPAN OR CHINA	ZZ
JAPAN PROP TAIWAN	ZZ
JAPANR P CHINA	ZZ
JAPAN RUSSIA	ZZ
JAPAN SEA	ZZ
JAPAN S FORMOSA	TW
JAPAN S LOO CHOO I	JP
JAPAN S W FORMOSA	TW
JAPAN TAIWAN	ZZ
JAPÃO	JP
JAPN	JP
JAPÓ	JP
JAPON	JP
JAPÓN	JP
JARVIS IS	UM
JARVIS ISLAND	UM
JAVA	ID
JAVA BALI	ID
JAVA I	ID
JAVA INDONESIA	ID
JAVA IS	ID
JAVA SEA	ZZ
JAWA	ID
JERSEY	JE
JERUSALEM	IL
JERUSALEM ISRAEL	IL
JETTE BELGIUM	BE
JEY	JE
JJAPAN	JP
JOBI I	ID
JOBI IS	ID
JOHNSTON ATOLL	UM
JOHNSTON I	UM
JOHNSTON ID	UM
JOHNSTON IS	UM
JOHNSTON ISLAND	UM
JOHNSTON ISLAND ATOL	UM
JOHORE	MY
JOLO SULU IS	ID
JOR	JO
JORDAN	JO
JORDANIA	JO
JORDÀNIA	JO
JORDANIE	JO
JORDAN N	JO
JORDAN PALESTINE	ZZ
JORDON	JO
JPN	JP
JUAN DE FUCA STRAIT	ZZ
JUAN DE NOVA ISLAND	TF
JUAN FERNANDEZ	CL
JUAN FERNANDEZ I	CL
JUAN FERNANDEZ IS	CL
JUAN FERNANDEZ ISL	CL
JUAN FERNANDEZ ISLANDS	CL
JUAN FERNÏNDEZ	CL
JUGOSLAVIA	ZZ
KALAO I	ID
KALAO IS	ID
KALIDUPA I	ID
KALIMANTAN	MY
KALMAR SWEDEN	SE
KAMEROON	CM
KAMERUM	CM
KAMERUN	CM
KANAGAWA JAPAN	JP
KANAKAKAI HAWAII USA	US
KANARISCHE EILANDEN	ES
KANGEAN	ID
KANGEAN I	ID
KANGEAN IS	ID
KANGERLUSSUAQ, GREENLAND	GL
KANJEAN IS	ID
KANSAS	US
KANSAS USA	US
KAOLACK SENEGAL	SN
KAPUNDA AUSTRALIA	AU
KAPUNDA AUTRALIA	AU
KAPUNDA NEAR ADELAIDE AUSTRALIA	AU
KARA SEA	RU
KARINTHIA	AT
KARLSKRONA SWEDEN	SE
KARLSRUHE GERMANY	DE
KARLSTAD SWEDEN	SE
KASACHSSR	KZ
KASHMIR	ZZ
KASUMI DISTRICT NUMAZU JAPAN	JP
KATANNING WEST AUSTRALIA	AU
KATASE JAPAN	JP
KAULI	ZZ
KAYES MALI	ML
KAZ	KZ
KAZACHSTAN	KZ
KAZAHKSTAN	KZ
KAZAJISTÁN	KZ
KAZAKATAN	KZ
KAZAKHISTAN	KZ
KAZAKHISTAN SSR	KZ
KAZAKH SSR	KZ
KAZAKHSTAN	KZ
KAZAKHSTAN KYRGYZSTAN	ZZ
KAZAKHSTAN QAZAQSTAN	KZ
KAZAKHSTAN RUSSIA	ZZ
KAZAKHSTAN TURKMENISTAN	ZZ
KAZAKSTAN	KZ
K C	ZZ
KEI IS	ID
KEN	KE
KENIA	KE
KENT	GB
KENTUCKY	US
KENTUCKY USA	US
KENT UK	GB
KENY	KE
KENYA	KE
KENYA B E A	KE
KENYA BORDER	KE
KENYA BUSH DES COLLINES	KE
KENYA CHAMU	KE
KENYA CIKUYU MARAGOLI	KE
KENYA CO	KE
KENYA COAST	KE
KENYA COL	KE
KENYA COLONY	KE
KENYA COLONY N F P	KE
KENYA DIST	KE
KENYA DISTR	KE
KENYA DISTRICT	KE
KENYA EMBU	KE
KENYA EMBU GIKUYU KIPSIGIS	KE
KENYA EMBU GIKUYU KISIGIS	KE
KENYA EMBU GIKUYU KISIGIS MERU SAMBURU	KE
KENYA EMBU SAMBURU TURKANA KAMBA GIKUYU	KE
KENYA GABBRA	KE
KENYA GIKUYU MERU	KE
KENYA KAMBA	KE
KENYA KENIA	KE
KENYA KIPSIGIS	KE
KENYA KIPSIGIS KAMBA EMBU KIPSIGIS	KE
KENYA LUO	KE
KENYA LUO EMBU GIKUYU KAMBA KIPSIGIS MASAI	KE
KENYA LUO EMBU KIPSIGIS	KE
KENYA MARAGOLI	KE
KENYA MASAÃ AMP KIPSIGIS	KE
KENYA MASAI	KE
KENYA NORTH	KE
KENYA OR TANZANIA	ZZ
KENYA OR UGANDA	ZZ
KENYA POKOT	KE
KENYA PRAIRIE ET BUSH	KE
KENYA RÃGION DU NORD	KE
KENYA RECETTE PROVENANT DEGYPTE	KE
KENYA SAMBURU	KE
KENYA SAMBURU TURKANA	KE
KENYA SOMALI	KE
KENYA SOUTH	KE
KENYA SOUTH EAST	KE
KENYA TANZANIA UGANDA	ZZ
KENYA TANZANIA ZANZIBAR	ZZ
KENYA TURKANA	KE
KENYA UGANDA	ZZ
KENYA WEST	KE
KERGUELEN	TF
KERGUELEN I	TF
KERGUELEN ID	TF
KERGUELEN IS	TF
KERGUELEN ISLAND	TF
KERGUELEN ISLANDS	TF
KERGUELEN ISLANDS FRANCE	TF
KERGUELEN ISLE	TF
KERGUELIN ISLANDS	TF
KERGUELLAN IS	TF
KERGUELLEN I	TF
KERMADEC I	NZ
KERMADEC IS	NZ
KERMADEC ISLANDS	NZ
KEY I	ID
KEY IS	ID
KEY I S	ID
KEY ISLANDS	ID
KGZ	KG
KHARTOUM SUDAN	SD
KHARTUM	SD
KHM	KH
KHOR OBHOUR	ZZ
KIEL FJORD BALTIC SEA	DE
KIESSEE GÃTTINGEN GERMANY	DE
KIJAKA ZAIRE	CD
KIKUYU	KE
KILIMANJARO	TZ
KILIMANJARO DISTRICT	TZ
KINA	CN
KINANIRA BURUNDI	BI
KINGDOM OF BELGIUM	BE
KINGDOM OF DENMARK	DK
KINGDOM OF MOROCCO	MA
KINGDOM OF NORWAY	NO
KINGDOM OF SAUDI ARABIA	SA
KINGDOM OF SPAIN	ES
KINGDOM OF THAILAND	TH
KINGDOM OF THE NETHERLANDS	NL
KINGDOM OF TONGA	TO
KING GEORGE ISLAND SOUTH SHETLAND ISLANDS ANTARCTICA	AQ
KINGMAN REEF	UM
KINSHASA ZAIRE	CD
KIO I	MH
KIO I	RU
KIR	KI
KIRG	KG
KIRGHIZIA	KG
KIRGHIZIE	KG
KIRGHIZISTAN	KG
KIRGHIZSTAN	KG
KIRGISTAN	KG
KIRGIZIYA	KG
KIRGIZSTAN	KG
KIRGSSR	KG
KIRGUISTÁN	KG
KIRGYZIYA	KG
KIRIBATI	KI
KIRIBATI GILBERT IS	KI
KIRIBATI GILBERT ISLANDS	KI
KIRIBATI LINE ISL	KI
KIRIBATI REPUBLIC	KI
KIRIWANA GROUP	PG
KISO DISTRICT NAGANO PREF JAPAN	JP
KISOEI I	ID
KISOEI I N OF KEY IS	ID
KISSER IS	ID
KITIRA	ZZ
KIVU BUSHI ZAÃRE RÃPUBLIQUE DÃMOCRATIQUE DU CONGO	CD
KLUANG MALAYSIA	MY
KM E OF PARAGUAY	PY
KNA	KN
KNOKKE BELGIUM	BE
KOER I	ID
KOER IS	ID
KOFU JAPAN	JP
KOGONI NIONO MALI	ML
KOKAND	UZ
KOLGUIEV I	RU
KONGO	ZZ
KONGO DU ZAÃRE RÃP DÃMOCRATIQUE DU CONGO	CD
KOOR I	FJ
KOR	KR
KORE	KR
KOREA	KR
KOREA DEMOCRATIC PEOPLE'S REPUBLIC	KP
KOREA D P RP	KP
KOREA FORMOSA	ZZ
KOREA REP	KR
KOREAREPUBLICOF	KR
KOREA REPUBLIC OF	KR
KOREAREPUBLIC OF	KR
KOREASOUTH	KR
KOREA SOUTH	KR
KORNIK	PL
KORRIDO	ID
KOSOVO	XK
KOSRAE	FM
KOSTI SUDAN	SD
KOTEKHAIE	IN
KOTZEBUE SOUND	US
KOWEÏT	KW
KRAKATAU IS	ID
KREFELD GERMANY	DE
KRITI	GR
KS	US
KUANTAN MALAYSIA	MY
KULA HAWAII USA	US
KUNK	ZZ
KURDESTAN	ZZ
KURDISTAN	ZZ
KURILE IS	RU
KURILE ISLANDS	RU
KURIL IS	RU
KURIL ISLANDS	RU
KURIL ISLANDS SEA OF OKHOTSK	RU
KURILS IS	RU
KURURI CHIBA PREFECTURE JAPAN	JP
KUSAIE IS	FM
KUWAIT	KW
KWATRECHT BELGIUM	BE
KWT	KW
KYOTO JAPAN	JP
KYRGYSTAN UZBEKISTAN	ZZ
KYRGYZ REPUBLIC	KG
KYRGYZSTAN	KG
L A	ZZ
LAB	ZZ
LAB BORN	ZZ
LAB BORN HYBRID	ZZ
LAB CROSS LJJ X A TEXANUM	ZZ
LABRADOR	CA
LABUAN ISLAND	MY
LAC HULEH	ZZ
LAC ISABAL	ZZ
LAC LEMAN	ZZ
LAC MARACAIBO	VE
LAC PARINO	ZZ
LAC TANGANYIKA	ZZ
LAC TITICACA	ZZ
LAC VICTORIA	ZZ
LADRONE ISLANDS	ZZ
LADRONES	ZZ
LAFAYETTE	ZZ
LA FERME AUX CROCODILES	FR
LAGOS	NG
LA GRANJA EXPT STATION NEGRON OCCIDENTAL PHILIPPINES	PH
LA GUADELOUPE	GP
LAJAS VALLEY PUERTO RICO	PR
LA JOLLA CALIFORNIA USA	US
LAKE CHIEMSEE BAVARIA GERMANY	DE
LAKE IJSSELMEER THE NETHERLANDS	NL
LAKE MENDOTA MADISON USA	US
LAKE OF VENERE AT PANTELLERIA ISLAND SOUTH OF SICILY ITALY	IT
LAKE SILBERSEE NÃRNBERG GERMANY	DE
LAKE SODON	US
LALIBELIA ETHIOPIA	ET
LA MARTINIQUE	MQ
LAMBOK	ID
LAMBOK I	ID
LAMBOK IS	ID
L AMERICA	ZZ
LAMIA GREECE	GR
LANGKLOOF EASTERN CAPE SOUTH AFRICA	ZA
LÃNKÃPING SWEDEN	SE
LANZAROTE I	ES
LAO	LA
LAOET ISLDS	ID
LAO PDR	LA
LAO PEOPLE S DEMOCRATIC REPUBLIC	LA
LAO RÉPUBLIQUE DÉMOCRATIQUE POPULAIRE	LA
LAOS	LA
LAOS CAMBODIA VIETNAM	ZZ
LAOS CHINOIS	ZZ
LAOS INDO CHINA	LA
LAOS RÉPUBLIQUE DÉMOCRATIQUE POPULAIRE	LA
LAOS SIAMOIS	ZZ
LAPAC I	ID
LAPLAND	ZZ
LAPLA ND	ZZ
LAPLAND NORWAY	NO
LAPONIE	ZZ
LAPPLAND	ZZ
LAQUEDIVES I	IN
LARAT I	ID
LA RÉUNION	RE
LA RÉUNION OU MADAGASCAR	ZZ
LA ROCHELLE FRANCE	FR
LAS ROLAS	ZZ
LATHAM I	TZ
LATHAM ISLAND	TZ
LATIN AMERICA	ZZ
LATIVA	LV
LATIVIA	LV
LATVIA	LV
LATVIA (LV)	LV
LA VEGA	DO
LAYSAN	US
LAYSAN I	US
LAYSAN ISLAND	US
LAYSAN ISLANDS	US
LBN	LB
LBR	LR
L BURMA	MM
LBY	LY
LCA	LC
LEADBURGHATCHERY OREGON USA	US
LEB	LB
LEBA	LB
LEBANON	LB
LEBANON N	LB
LEBANON S	LB
LEBANON SYRIA	ZZ
LEEDS UK	GB
LEEWARD COAST OF ST VINCENT B W I	VC
LEEWARD ISLANDS	ZZ
LEGON	GH
L EGYPT	EG
LEICESTER ENGLAND	GB
LEICESTER ENGLAND UK	GB
LEICESTER UK	GB
LEIDEN THE NETHERLANDS	NL
LEIPZIG GERMANY	DE
LEMBERGE BELGIUM	BE
LENYA COL	KE
LEOPOLDSDORF AUSTRIA	AT
LÉOPOLDVILLE	CD
LESOTHO	LS
LESOTO	LS
LES SAINTES	GP
LESSER ANTARTICA	AQ
LESSER ANTILLES	ZZ
LESSER ANTILLES ANTIGUA	AG
LESSER ANTILLES BARBADOS	BB
LESSER ANTILLES DOMINICA	DM
LESSER ANTILLES GRENADA	GD
LESSER ANTILLES GUADELOUPE ISLAND	GP
LESSER ANTILLES MARTINIQUE	MQ
LESSER ANTILLES MONTSERRAT	MS
LESSER ANTILLES SAINT LUCIA	LC
LESSER ANTILLES SAINT VINCENT	VC
LESSER ANTILLES ST VINCENT	VC
LESSER ANTILLIES	ZZ
LESSER SUNDA IS	ID
LESSER SUNDA ISL	ID
LESSER SUNDA ISLANDS	ID
LESSER SUNDAS	ID
LESSINES BELGIUM	BE
LETONIA	LV
LETTI I	ID
LETTI IS	ID
LETTONIE	LV
LEUSDEN THE NETHERLANDS	NL
LEUVEN BELGIUM	BE
LEVANT	ZZ
L EX RÉPUBLIQUE YOUGOSLAVE DE MACÉDOINE	MK
LIAONING	CN
LIAONING PROVINCE CHINA	CN
LIBAN	LB
LÍBANO	LB
LIBANON	LB
LIBERA	LR
LIBERIA	LR
LIBÉRIA	LR
LIBÈRIA	LR
LIBERIA CAMEROON	ZZ
LIBÉRIA CÔTE D IVOIRE	ZZ
LIBERIA OR SIERRA LEONE	ZZ
LIBERIEA	LR
LIBIA	LY
LÍBIA	LY
LĪBIYĀ	LY
LIBYA	LY
LIBYANARABJAMAHIRIYA	LY
LIBYAN ARAB JAMAHIRIYA	LY
LIBYE	LY
LICHTENSTEIN	LI
LIE	LI
LIECHENSTEIN	LI
LIECHTENSTEIN	LI
LIETTUA (LT)	LT
LIETUVA	LT
LIKASISUD CONGO	CD
LIKELY TRINIDAD	TT
L ILE DE LA RÉUNION	RE
LIMON COSTA RICA	CR
LIMOUSIN FRANCE	FR
LINCOLN NEBRASKA USA	US
LINDHORST HANNOVER GERMANY	DE
LINE I	ZZ
LINE IS	ZZ
LINE ISLAND	ZZ
LINE ISLANDS	ZZ
LINE ISLAND S	ZZ
LINES	ZZ
LINGGA I	ID
LINGGA IS	ID
LIR	ZZ
LITHUANIA	LT
LITTLE CARPATHIANS	SK
LITTLE KEY I	ID
LITTLE KEY IS	ID
LITTLE KEY I S	ID
LITTLE KEY ISLAND	ID
LITTLE KEY ISLANDS	ID
LITTLE SWAN ISLAND	AU
LITUANIA	LT
LITUANIE	LT
LIVINGSTON ISLAND SOUTH SHETLAND ISLANDS ANTARCTICA	AQ
LIVLAND	ZZ
LIVNO YUGOSLAVIA	BA
LJUBLJANA SLOVENIA	SI
LKA	LK
LLOYDS I	AQ
LOCAILTY UNKNOWN	ZZ
LOCALITY DATA U	ZZ
LOCALITY DATA UNKNOWN	ZZ
LOCALITY DATA UNKOWN	ZZ
LOCALITY NOT KNOWN	ZZ
LOCALITY UNKNOW	ZZ
LOCALITY UNKNOWN	ZZ
LOCKYER VALLEY QUEENSLAND AUSTRALIA	AU
LOGAN UTAH USA	US
LOMBLEM	ID
LOMBLEN	ID
LOMBLEN I	ID
LOMBLEN IS	ID
LOMBOK	ID
LOMBOK I	ID
LOMBOK IS	ID
LOMMEL BELGIUM	BE
LOMOOK IS	ID
LONDERZEEL BELGIUM	BE
LONDON ENGLAND	GB
LONDON ONTARIO CANADA	CA
LONDON UK	GB
LONG ISLAND USA	US
LOO CHOO IS	JP
LOPEZ BOHOL PHILIPPINES	PH
LORD HOWE I	AU
LORD HOWE I OR NORFOLK I	AU
LORD HOWE IS	AU
LORD HOWE ISL	AU
LORD HOWE ISLAND	AU
LORD HOWE ISLAND AUSTRALIA	AU
LOS ANGELES USA	US
LOS BANOS LAGUNA PHILIPPINES	PH
LOT FRANCE	FR
LOUISIADE ARCH	PG
LOUISIADE I	PG
LOUISIADE IS	PG
LOUISIAIDE ARCH	PG
LOUISIANA	US
LOUISIANA USA	US
LOUSSIADE I	PG
LOW ANGOLA	AO
LOW BURMA	MM
LOW CONGO	ZZ
LOW COUNTRY BALI	ID
LOW COUNTRY BALI IS	ID
LOW COUNTRY NEW GUINEA	ZZ
LOW EGYPT	EG
LOWER AMAZON	BR
LOWER AUSTRIA	AT
LOWER BURMA	MM
LOWER CAL	MX
LOWER CALIF	MX
LOWER CALIFORNIA	MX
LOWER CONGO	ZZ
LOWER CONGO FREE ST	CD
LOWER CONGO F S	CD
LOWER CONGO F ST	CD
LOWER EGYPT	EG
LOWER HUTT NEW ZEALAND	NZ
LOWER INDIA	IN
LOWER PEGU	PE
LOWER SAXONY GERMANY	DE
LOWR CALIF	MX
LOYALTIES	NC
LOYALTY GROUP	NC
LOYALTY IS	NC
LOYALTY ISLANDS	NC
LOYAUTE I	NC
LOYAUTÉ ISLAND	NC
LSO	LS
LTU	LT
LUCTUGAN ROXAS CITY PHILIPPINES	PH
LUDHIANA INDIA	IN
LUND SWEDEN	SE
LUO DU SIAYA KENYA	KE
LUX	LU
LUXEMBOURG	LU
LUXEMBURG	LU
LUXEMBURGO	LU
LUZON	PH
LUZON I	PH
LUZON IS	PH
LVA	LV
LYBIA	LY
LYBIAN DESERT	LY
LYON FRANCE	FR
M	ZZ
MAASLAND THE NETHERLANDS	NL
MAC	MO
MACAO	MO
MACAO SPECIAL ADMINISTRATIVE REGION OF CHINA	MO
MACAU	MO
MACAULEY I	NZ
MACDONALD COLLEGE QUEBEC CANADA	CA
MACÉDOINE	MK
MACÉDOINE L EX RÉPUBLIQUE YOUGOSLAVE DE	MK
MACEDONIA	MK
MACEDONIA FORMER YUGOSLAV REPUBLIC OF	MK
MACEDONIA THE FORMER YUGOSLAV REPUBLIC OF	MK
MACQUARIE I	AU
MACQUARIE IS	AU
MACQUARIE ISL	AU
MACQUARIE ISLAND	AU
MACQUARIE ISLAND ANTARCTICA	AU
MACQUARRIE IS	AU
MAD	MG
MADA	MG
MADACASGAR	MG
MADAGASACAR	MG
MADAGASCA	MG
MADAGASCAR	MG
MADAGASCAR ALDABRA	ZZ
MADAGASCAR FORM REP MALAGASY	MG
MADAGASCAR HAUTSPLATEAUX	MG
MADAGASCAR I	MG
MADAGASCAR INDIAN OCEAN	MG
MADAGASCAR MAURITIUS	ZZ
MADAGASCAR SE	MG
MADAGASCAR TANANARIVE	MG
MADAGASIKARA	MG
MADAGASKAR	MG
MADAG S W	MG
MADEIRA	PT
MADEIRA ATLANTIC OCEAN	PT
MADEIRA I	PT
MADEIRA IS	PT
MADEIRA ISLAND	PT
MADEIRA ISLANDS	PT
MADEIRA PORTUGAL	PT
MADEIRAS	PT
MADERAS ISLANDS	PT
MADERE I	PT
MADERIA IS	PT
MADGASCAR	MG
MADIERA	PT
MADRID AREA SPAIN	ES
MADRID SPAIN	ES
MAF	MF
MAFFLE BELGIUM	BE
MAFOR I	ID
MAFOR IS	ID
MAGADOR	MA
MAGDALEN ISLDS	CA
MAHARASHTRA STATE	IN
MAINE	US
MAIN HAWAIIAN ISLANDS	US
MAJORCA	ES
MAJORCA I E OF SPAIN	ES
MAKATKATUIT GUIMBA NUEVA ECIJA PHILIPPINES	PH
MAKE	MK
MAKIN IS	KI
MAL	MY
MALA	ZZ
MALABAR COAST	IN
MALACCA	ID
MALACCA MALAYSIA	MY
MALACCA OR BORNEO	ZZ
MALACCA OR MOLUCCAS	ZZ
MALACCA STRAIT	ZZ
MALACCA STRS	ID
MALACCO	ZZ
MALAGASY	MG
MALAGASY REPUBLIC	MG
MALÀISIA	MY
MALAISIE	MY
MALAITA	SB
MALASIA	MY
MALAUI	MW
MALAWI	MW
MALAWI FORM NYASALAND	MW
MALAWI MOZAMBIQUE TANZANIA	ZZ
MALAWINYASALAND	MW
MALAWI NYASALAND	MW
MALAWI NYASSALAND	MW
MALAWI OLIM NYASALAND	MW
MALAY	ZZ
MALAYA	ZZ
MALAYA BRUNEI	BN
MALAYA MALAYSIA	MY
MALAY ARCHIPELAGO	ZZ
MALAY ARCHIPELIGO	ZZ
MALAYASIA	MY
MALAYASIA OR INDONESIA	ZZ
MALAYA SINGAPORE I	SG
MALAYA THAILAND	TH
MALAY PEN	ZZ
MALAY PENIN	ZZ
MALAY PENINS	ZZ
MALAY PENIN SIAM	TH
MALAY PENINSULA	ZZ
MALAY PENINSULA MALAYSIA	MY
MALAY PENINSULAR MALAYSIA	MY
MALAY PENINSULA SINGAPORE	SG
MALAY PENISULA	ZZ
MALAY PENN	ZZ
MALAY PENNINSULA	ZZ
MALAY REGION	ZZ
MALAYSIA	MY
MALAYSIA AND SINGAPORE	ZZ
MALAYSIA E	MY
MALAYSIA INDONESIA	ZZ
MALAYSIA MALAYA	MY
MALAYSIA OR INDONESIA	ZZ
MALAYSIA OR THAILAND	ZZ
MALAYSIA PENINSULAR THAILAND	ZZ
MALAYSIA SABAH	MY
MALAYSIA SARAWAK	MY
MALAYSIA SINGAPORE	SG
MALAYSIA SINGAPORE	ZZ
MALAYSIA THAILAND	TH
MALAYSIA THAILAND	ZZ
MALAYSIA TIMOR	ZZ
MALAYSIA UNKNOWN	MY
MALAYSIA W	MY
MALAYSIA WEST	MY
MALAY STATES	ZZ
MALDEGEM BELGIUM	BE
MALDEN	KI
MALDEN ISLAND	KI
MALDEN ISLANDS	KI
MALDIVAS	MV
MALDIVE IS	MV
MALDIVE ISLANDS	MV
MALDIVE ISLAND S	MV
MALDIVES	MV
MALDIVES I	MV
MALDIVES INDIAN OCEAN	MV
MALESIA	MY
MALI	ML
MALÍ	ML
MALINAO NARRA PALAWAN PHILIPPINES	PH
MALI OU GUINÉE	ZZ
MALI RÃGIONS SIKASSO BOUGOUNI	ML
MALLORCA	ML
MALLORCA BALEARIC ISLANDS	ES
MALLORCA I	ES
MALLORCA I E OF SPAIN	ES
MALLORCA SPAIN	ES
MALMÃ SWEDEN	SE
MÃLMO SWEDEN	SE
MÃLNDAL SWEDEN	SE
MALORCA	ES
MALOUINES I	FK
MALPELO IS	CO
MALPELO ISLAND	CO
MAL PEN	ZZ
MALPEO IS	CO
MALTA	MT
MALTA I	MT
MALTA IS	MT
MALTE	MT
MALTE I	MT
MALTI I	MT
MALUKU	ID
MALWAI	MW
MALYASIA	MY
MANCHE	ZZ
MÃNCHEN GERMANY	DE
MANCHESTER UK	GB
MANCHURIA	CN
MANDAPAM INDIA	IN
MANDRAIN	ZZ
MANDUKI LAL	IN
MANGGOER I	ID
MANGGOER IS	ID
MANIHIKI GROUP	CK
MANILA PHILIPPINES	PH
MANITOBA	CA
MANITOBA CANADA	CA
MANOORA SOUTH AUSTRALIA	AU
MANTANANI IS	MY
MANTCHOURIE	CN
MAR	MA
MARCUS ISLAND	JP
MARCUS NECKER RISE	ZZ
MARGUESA IS	PF
MAR I	ZZ
MARIANA IS	MP
MARIANA ISLAND	MP
MARIANA ISLANDS	MP
MARIANAS	MP
MARIANAS CAROLINES	ZZ
MARIANAS IS	MP
MARIANAS IS	ZZ
MARIANAS ISLANDS	ZZ
MARIANNE I	SC
MARIANNE IS	SC
MARIANNE I S	SC
MARIANNE ISLANDS	MP
MARIANNE OR JAPAN	ZZ
MARIANNES	ZZ
MARIANNES DU NORD ÎLES	MP
MARIANNES I	ZZ
MARIANS ISLAND	MP
MARIEGALANTE	GP
MARIE GALANTE	GP
MARION ISLAND	ZA
MARITIUS	MU
MARKE BELGIUM	BE
MAROC	MA
MAROCCO	MA
MAROC ORIENTAL	MA
MAROUA CAMEROON	CM
MARQ	PF
MARQUESA IS	PF
MARQUESAS	PF
MARQUESAS I	PF
MARQUESAS IS	PF
MARQUESAS IS FR	PF
MARQUESAS ISL	PF
MARQUESAS ISLAND	PF
MARQUESAS ISLANDS	PF
MARROC	MA
MARROCOS	MA
MARRUECOS	MA
MARSEILLE FRANCE	FR
MARSHALL	MH
MARSHALL I	MH
MARSHALL IDS	MH
MARSHALL ÎLES	MH
MARSHALL IS	MH
MARSHALL ISL	MH
MARSHALL ISLANDS	MH
MARSHALL ISLANDS REPUBLIC OF	MH
MARSHALL ISLS	MH
MARSHALLS	MH
MART	MQ
MARTIN HOUSE NORTHWEST TERRITORIES CANADA	CA
MARTINICA	MQ
MARTINIQUE	MQ
MARTINIQUE FRENCH WEST INDIES	MQ
MARTINIQUE ISLAND	MQ
MARTINIQUE ST LUCIA	MQ
MARTINIQUE WEST INDIES	MQ
MARTINQUE	MQ
MARYLAND	US
MARYLAND USA	US
MASAILAND	KE
MASCAREIGNES	ZZ
MASCARENE IS	ZZ
MASCARENE ISLANDS	ZZ
MASCARENES	ZZ
MASSACHUSETTS	US
MASSACHUSETTS GEORGIA USA	US
MASSACHUSETTS USA	US
MATTHEW ET HUNTER I	NC
MATUKU I	FJ
MAU	ZZ
MAUI HAWAII USA	US
MAURETANIA	MR
MAURICE	MU
MAURICE I	MU
MAURICI	MU
MAURICIO	MU
MAURITANIA	MR
MAURITANIA MOROCCO	ZZ
MAURITANIE	MR
MAURITANIE OCCIDENTALE	MR
MAURITANIE RÃGION DE CHINGETTI	MR
MAURITIUS	MU
MAURITIUS I	MU
MAURITIUS I E OF AFRICA	MU
MAURITIUS ILE MAURICE	MU
MAURITIUS INDIAN OCEAN	MU
MAURITIUS IS	MU
MAURITIUS IS INDIAN OCEAN	MU
MAURITIUS ISLAND	MU
MAURITIUS ISLAND S	MU
MAURITIUS OR RODRIGUEZ	MU
MAURITIUS PROBABLY	MU
MAW	ZZ
MAY	ZZ
MAYANMAR	MM
MAY AUSTRALIA	ZZ
MAYLASIA	MY
MAYO IRELAND	IE
MAYOTTE	YT
MAZEDONIA	MK
MCKEAN IS	KI
MCKEAN ISLAND	KI
MCO	MC
MDA	MD
MDG	MG
MDV	MV
MEDITERRANEAN	ZZ
MEDITERRANEAN ISLANDS	ZZ
MEDITERRANEAN SEA	ZZ
MEDITERRANEAN SEA ISRAEL	IL
MEDITTERRANEAN SEA	ZZ
MEIDERA	PT
MEIDERA ARCHIPEL	PT
MELANESIA	ZZ
MELANESIE	ZZ
MÉLANÉSIE	ZZ
MELAYSIA	MY
MELBOURNE AUSTRALIA	AU
MELCHIOR ISLANDS	AQ
MELLE BELGIUM	BE
MENAI STRAIT UK	GB
MENGALUM IS	MY
MENTAWI ISLANDS	ID
MENTEKAB MALAYA	MY
MER ADRIATIQUE	ZZ
MER BALTIQUE	ZZ
MER CASPIENNE	ZZ
MER CELTIQUE	ZZ
MER D ALBORAN	ZZ
MER D ANDAMAN	ZZ
MER D ARAFURA	ZZ
MER D AUSTRALIE	ZZ
MER DE BARENTS	ZZ
MER DE BERING	ZZ
MER DE CHINE	ZZ
MER DE CORAIL	ZZ
MER DE KARA	ZZ
MER DE NORVÈGE	ZZ
MER DE ROSS	AQ
MER DE SARCOSA	ZZ
MER DES CARAIBES	ZZ
MER DES CELEBES	ZZ
MER DE SCOTIA	ZZ
MER DES INDES	ZZ
MER DES MOLUQUES	ZZ
MER DES SARGASSES	ZZ
MER DE TIMOR	ZZ
MER DE WEDDELL	AQ
MER D IRLANDE	ZZ
MER D OMAN	ZZ
MER DU LABRADOR	ZZ
MER DU NORD	ZZ
MER DU SUD	ZZ
MER EGEE	ZZ
MER EGEE DU NORD	ZZ
MER EGEE DU SUD	ZZ
MERELBEKE BELGIUM	BE
MERIDA VENEZUELA	VE
MER IONIENNE	ZZ
MER MEDITERRANEE	ZZ
MER MORTE	ZZ
MER NOIRE	ZZ
MER ROUGE	ZZ
MERS AUSTRALES	ZZ
MERS DU SUD	ZZ
MESLIN LEVÃªQUE BELGIUM	BE
MES MIDSAYAP NORTH COTABATO PHILIPPINES	PH
MESOPOTAMIA	ZZ
MÉSOPOTAMIE	ZZ
MESOPOTOMIA	ZZ
MESOPTAMIA	ZZ
METSOPOTAMIA	ZZ
MEW ZEALAND	NZ
MEX	MX
MEXCIO	MX
MEXCO	MX
MEXIC	MX
MÈXIC	MX
MEXICA	MX
MEXICAN BOUNDARY LINE	MX
MEXICAO	MX
MEXICO	MX
MÉXICO	MX
MEXICO AND CENTRAL AMERICA	ZZ
MEXICO BY INFE	MX
MEXICO BY INFERENCE	MX
MEXICO CENTRAL AND SOUTH AMERICA	ZZ
MEXICO D F	MX
MEXICO EL SALVADOR	ZZ
MEXICO GUATEMALA	ZZ
MEXICO JAMAICA	ZZ
MEXICO MEXIQUE	MX
MEXICO NICARAGUA	ZZ
MEXICO OR GUATEMALA	ZZ
MEXICO OR S AMERICA	ZZ
MEXICO OR USA	ZZ
MEXICO PROBABLY	MX
MEXICO S	MX
MEXICO SOUTHEAST	MX
MEXICO TO W PERU N ARGENTINA	ZZ
MEXICO UNITED STATES	ZZ
MEXICO USA	ZZ
MEXICO U S A	ZZ
MEXICP	MX
MEXIDO	MX
MEXIICO	MX
MEXIQUE	MX
MEX LA PAZ	MX
MEX MEXICO	MX
MHL	MH
MICHIGAN	US
MICHIGAN USA	US
MICRONESIA	FM
MICRONESIA FEDERATED STATES	FM
MICRONESIA FEDERATED STATES OF	FM
MICRONESIAFS	FM
MICRONESIA FS	FM
MICRONESIA MARIANAS	ZZ
MICRONESIA OR PALAU	ZZ
MICRONESIA US TRUST TERR	FM
MICRONESIE	FM
MICRONÉSIE	FM
MICRONÉSIE ETATS FÉDÉRÉS DE	FM
MICRONÉSIE ÉTATS FÉDÉRÉS DE	FM
MID ANDAMAN IS	IN
MIDDENFRANKRIJK	FR
MIDDLE ANDAMAN IS	IN
MIDDLE ASIA	ZZ
MIDDLE EAST TO BANGLADESH	ZZ
MIDDLE W MADAGASCAR	MG
MID E MADAGASCAR	MG
MID ENG	GB
MIDLAND CENTER W MADAGASCAR	MG
MIDSAYAG NORTH CATABATO PHILIPPINES	PH
MIDWAY	UM
MIDWAY ATOLL UNITED STATES MINOR OUTLYING ISLANDS	UM
MIDWAY I	UM
MIDWAY IS	UM
MIDWAY ISLAND	UM
MIDWAY ISLANDS	UM
MIDWEST AUSTRALIA	AU
MID W MADAGASCAR	MG
MIGAYI PREFECTURE JAPAN	JP
MILFORD CONNECTICUT USA	US
MILNE BAY	PG
MINDANAO IS	PH
MINDEN GERMANY	DE
MINDORO	PH
MINNEAPOLIS USA	US
MINNESOTA	US
MINNESOTA USA	US
MINTER CREEK FISH HATCHERY WASHINGTON STATE USA	US
MI OFF COAST OF NICARAGUA	NI
MISOL I	ID
MISOL IS	ID
MISSISSIPI RIVER USA	US
MISSOURI	US
MISSOURI USA	US
MITAKA TOKYO JAPAN	JP
MIYAGI PREFECTURE JAPAN	JP
MKD	MK
MLI	ML
MLT	MT
MMR	MM
MNE	ME
MNG	MN
MNP	MP
MOA I	AU
MOA ISLANDS	AU
MOBARA CHIBA PREF JAPAN	JP
MOBAYI ZAIRE	CD
MOÇAMBIC	MZ
MOCAMBIQUE	MZ
MOÇAMBIQUE	MZ
MOCAMBIQUE MOZAMBIQUE	MZ
MOERBEKE BELGIUM	BE
MOG	MN
MOJAVE DESERT ROSAMOND CALIFORNIA USA	US
MOLDAVIA	MD
MOLDAVIE	MD
MOLDOVA	MD
MOLDOVA REP	MD
MOLDOVA RÉPUBLIQUE DE	MD
MOLDOVA UKRAINE	ZZ
MOLLUCCAS	ID
MOLOKAI HAWAII USA	US
MOLRAUW BELGIUM	BE
MOLUCCA	ID
MOLUCCA I	ID
MOLUCCA IS	ID
MOLUCCA ISLANDS	ID
MOLUCCA ISLES	ID
MOLUCCAS	ID
MOLUCCA S	ID
MOLUCCAS IS	ID
MOLUCCAS ISLANDS	ID
MOLUCCA STRAIT	ID
MOLUQUES	ID
MONACO	MC
MÓNACO	MC
MONA ISLAND	PR
MONAUBERT FRANCE	FR
MONGOLIA	MN
MONGÒLIA	MN
MONGOLIA KAZAKHSTAN	ZZ
MONGOLIAN PEOPLE S REPUBLIC	MN
MONGOLIAN PEOPLES REPUBLIC	MN
MONGOLIAN REPUBLIC	MN
MONGOLIE	MN
MONSERRAT	MS
MONTANA USA	US
MONTENEGRO	ME
MONTÉNÉGRO	ME
MONTEREY COUNTY CALIFORNIA USA	US
MONTREUIL FRANCE	FR
MONTSERRAT	MS
MONTSERRAT BR LESSER ANTILLES	MS
MONTST GUIBERT	BE
MOOREA	PF
MOOS GERMANY	DE
MORACCO	MA
MOROC	MA
MOROCCO	MA
MOROCCO ALGERIA	ZZ
MOROCCO E	MA
MOROCCO N AFRICA	MA
MOROCCO OR ALGERIA	ZZ
MOROCO	MA
MORROCCO	MA
MORROCO	MA
MORTY I	ID
MORTY ISLAND	ID
MOSCOW RUSSIA	RU
MOSCWA RIVER FORMER USSR	RU
MOSSAMBIQUE	MZ
MOUNTAINS OF NEW GUINEA	ZZ
MOUNT RITTMANN ANTARCTICA	AQ
MOYEN CONGO	ZZ
MOYEN ORIENT	ZZ
MOZ	MZ
MOZAMBIQUE	MZ
MOZAMBIQUECA	MZ
MOZAMBIQUE CHANNEL	ZZ
MOZAMBIQUE CHANNEL ISLANDS	ZZ
MOZAMBIQUE I	MZ
MOZAMBIQUE MAPUTO	MZ
MOZAMBIQUE NYASSALAND FRONTIER	MZ
M R BAROTSELAND	ZM
MRT	MR
MSR	MS
MTQ	MQ
MTS OF BRIT NEW GUINEA	PG
MTS OF VENEZUELA	VE
MUNANIRA BURUNDI	BI
MUNICH GERMANY	DE
MURRAY BRIDGE SOUTH AUSTRALIA	AU
MURRAY ISLAND	ZZ
MURRAY OKLAHOMA UNITED STATES	US
MUS	MU
MUSCAT	OM
MUSCAT AND OMAN	OM
MUSEO CORRER VENICE ITALY	IT
MUSEUM	ZZ
M W D NEW GUINEA	ID
MWI	MW
MXICO	MX
MYANMAR	MM
MYANMAR BURMA	MM
MYANMAR THAILAND	ZZ
MYS	MY
MYT	YT
N A	ZZ
N AFRICA	ZZ
NAGAMILAND	BW
NAGANO PREFECTURE JAPAN	JP
NAGOYA JAPAN	JP
NAIGARA MASAI	KE
NAIROBI	KE
NAIROBI KENYA	KE
N ALBANIA	AL
N ALGERIA	DZ
NAM	NA
NAMAIBIA	NA
NAMAQUALAND	ZZ
NAMB	NA
NAMBIA	NA
N AMER	ZZ
N AMERICA	ZZ
N AMERICA CANADA OR U S A	ZZ
N AMERICA S E OF U S A	US
N AMERICA U S A	US
NAMIBIA	NA
NAMÍBIA	NA
NAMIBIA OR BOTSWANA	ZZ
NAMIBIA SOUTH AFRICA	ZZ
NAMIBIA SOUTHWEST AFRICA	NA
NAMIBIA SWA	NA
NAMIBIE	NA
NAMX	ZZ
NANCY	FR
N ANDAMAN I	IN
N ANDAMAN IS	IN
N AND S BIMINI	BS
N ANGOLA	AO
NANJING CHINA	CN
NANTOU CO	TW
NAPA	US
NAPAL VALLEY	NP
NAPLES	IT
N ARABIA	ZZ
NARBONNE FRANCE	FR
NARCONDAM I	IN
NARES STRAIT	ZZ
N ARGENTINA	AR
NÃRNBERG GERMANY	DE
NASAU BAHAMAS	BS
NASHVILLE USA	US
NATAL	ZA
NATAL PROVINCE	ZA
N ATLANTIC	ZZ
N ATLANTIC OCEAN	ZZ
N ATLANTIC SCOTLAND U K	GB
NATUNA I	ID
NATUNA IS	ID
NATUNAS	ID
NAUNA ISLANDS	PG
NAURA ISLAND PACIFIC OCEAN JAPAN	ZZ
NAURU	NR
NAURU ISLAND	NR
NAURU REPUBLIC OF	NR
N AUSTRALIA	AU
N AUSTRIA	AT
NAVASSA	UM
NAVASSA ID	UM
NAVASSA IS	UM
NAVASSA ISLAND	UM
NAVASSA ISLAND S	UM
N BAHAMAS	BS
N BECHOANALAND	BW
N BECHUANALAND	BW
N BELG CONGO	CD
N BIMINI	BS
N BORNEA	ZZ
N BORNEO	ZZ
N BORNEO BRUNEI	BN
N BOTSWANA	BW
N BOUNDRY OF MEXICO	MX
N BRAZIL	BR
N BRITAIN IS	PG
N BRIT NEW GUINEA	PG
N BR NEW GUINEA	PG
N B SCOTLAND	GB
N B SCOTLAND U K	GB
N BULGARIA	BG
N BURMA	MM
NCAL	ZZ
N CAMEROON	CM
N CAMEROON HIGHLAND	CM
N CAMEROON HIGHLANDS	CM
N CAMEROONS	CM
N CAROLINA	US
N CAUCASUS	ZZ
N C AUSTRALIA	AU
N CELEBES	ID
N CELEBES IS	ID
N CELEBES SULAWESI	ID
N CENT AUSTRALIA	AU
N CEYLON	LK
N CHINA	CN
NCL	NC
N COAST BR NEW GUINEA	PG
N COAST D NEW GUINEA	ID
N COAST D N GUINEA	ID
N COAST DU NEW GUINEA	ID
N COAST GERMAN N GUINEA	PG
N COAST GER NEW GUINEA	PG
N COAST M TS VENEZUELA	VE
N COAST MTS VENEZUELA	VE
N COAST NEW GUINEA	ZZ
N COAST OF FRANCE	FR
N COAST OF GER NEW GUINEA	PG
N COAST OF NEW GUINEA	ZZ
N COAST OF PAPUA N GUINEA	PG
N COAST OF VENEZUELA	VE
N COLOMBIA	CO
N CONGO	ZZ
N CONGO F ST	CD
N DALMATIA	HR
NDERLAND	NL
N D NEW GUINEA	ID
N DU NEW GUINEA	ID
NEA	ZZ
N E AFRICA	ZZ
N E ALGERIA	DZ
N E AMERICA	ZZ
NEAR ALICANTE SPAIN	ES
NEAR AUSTRALIA	AU
NEAR BOUNDARY OF SWEDEN NORWAY FINLAND	ZZ
NEAR CERAM LAUT	ID
NEAR CERAM LAUT IS	ID
NEAR EAST	ZZ
NEAR ENGLAND	GB
NEAR GALAPAGOS IS	EC
NEAR HALE CENTER TEXAS USA	US
NEAR HILDENBOROUGH KENT UK	GB
NEAR HUDSON NEW YORK USA	US
NEAR JAVA	ID
NEAR JOBI I	ID
NEAR KEY IS	ID
NEAR LAKE LERMA MEXICO	MX
NEAR LAKE TAUPO NEW ZEALAND	NZ
NEAR MADEIRA I	PT
NEAR MOMBASA UGANDA	UG
NEAR NEUCHÃTEL SWITZERLAND	CH
NEAR NEW ZEALAND	NZ
NEAR NICE FRANCE	FR
NEAR N NEW BRITAIN	PG
NEAR NORDMALUNG SWEDEN	SE
NEAR N ZEALAND	NZ
NEAR PANAMA	PA
NEAR RIVER NISCHENKA MOSCOW REGION FORMER USSR	RU
NEAR SEYCHELLES IS	SC
NEAR SULA IS	ID
NEAR SUMBAWA	ID
NEAR SUMBAWA I	ID
NEAR SUMBAWA LESSER SUNDA IS	ID
NEAR SYRACUSE NEW YORK USA	US
NEAR TOKYO JAPAN	JP
NEAR TRISTAN CUNHA	SH
NEAR TUNIS	TN
NEAR VENEZUELA	VE
NEAR ZOTTEGEM BELGIUM	BE
N E AUSTRALIA	AU
N E BELGIAN CONGO	CD
N E BORNEO	ZZ
NE BOSNIAHERZEGOVINA	BA
NEBRASKA	US
NEBRASKA USA	US
N E BRAZIL	BR
NE BRAZIL	BR
N E BRITISH NEW GUINEA	PG
N E BRITISH SOMALILAND	SO
N E BRIT NEW GUINEA	PG
N E BRIT N GUINEA	PG
N E BR NEW GUINEA	PG
N E BURMA	MM
N E CAMEROON	CM
N E CAMEROONS	CM
N E CANADA	CA
N E CELEBES	ID
N E CEYLON	LK
NECHES	US
N E CHINA	CN
N E COAST MADAGASCAR	MG
N E COAST OF D NEW GUINEA	ID
N E COAST VENEZUELA	VE
N ECUADOR	EC
NEDERALND	NL
NEDERBOELARE BELGIUM	BE
NEDERLAND	NL
N E DU NEW GUINEA	ID
NÉE À LA RÉUNION	RE
N E ECUADOR	EC
NE ECUADOR	EC
NEEDS EDITING	ZZ
NÉ EN CAPTIVITÉ	ZZ
N E ENGLAND	GB
NEEROETEREN BELGIUM	BE
N E ETHIOPIA	ET
N E GERMANY	DE
N E GREENLAND	GL
NEGROS IS	PH
N EGYPT	EG
N E ICELAND	IS
N E INDIA	IN
NE IRAQ	IQ
N E ITALY	IT
N E JAVA	ID
N E KOREA	KR
N E KOREA	ZZ
N E MADAGASCAR	MG
NE MADAGASCAR	MG
N E MALAY PEN	ZZ
N E MALAY PENIN	ZZ
N E MALAY PENINS	ZZ
N E MALAY PENINSULA	ZZ
N E MOROCCO	MA
N END OF SAN THOMÉ	ST
N END OF SAN THOMÉ IS	ST
N END OF SAN TOMÉ IS	ST
N E NEW GUINEA	ZZ
N ENGLAND	GB
N E N GUINEA	PG
N E NIGERIA	NG
N E OD JAVA	ID
N E OF ANDAMAN IS	IN
N E OF AUSTRALIA	AU
N E OF BORNEO	ZZ
N E OF CELEBES	ID
N E OF GERMANY	DE
N E OF GUINEA	GN
N E OF JAVA	ID
N E OF N GUINEA	PG
N E OF SUMATRA	ID
N E OF TUNIS	TN
NEOTROPICS	ZZ
NEPAL	NP
NÉPAL	NP
NEPAL FEDERAL DEMOCRATIC REPUBLIC OF NEPAL	NP
NEPAL INDIA	ZZ
NEPAL SIKKIM FRONTIER	ZZ
NEPAL SKKIM FRONTIER	ZZ
NEPAL VALLEY	NP
N E P EC	EC
N E P EC	ZZ
N E PERSIA	ZZ
N E PERU	PE
NE PERU	PE
N E PRUSSIA	ZZ
NER	NE
N E RHODESIA	ZW
NERITIC ZONE NEAR NICE FRANCE	FR
N ERITREA	ER
N ERN BRIT NEW GUINEA	PG
N ERN INDIA	IN
N ERN NIGERIA	NG
N E RUANDA	RW
NE RUMANIA	RO
N E RUSSIA	RU
N E SCOTLAND	GB
N E SIBERIA	RU
NE SIBERIA	RU
N E SUMATRA	ID
NE SUMATRA	ID
N E SUMATRA DELI	ID
N E SUMATRA DELI ETC	ID
N E SUMATRA I	ID
N E TANZANIA	TZ
NE THAILAND	TH
NETHANTILLES	ZZ
NETHEN BELGIUM	BE
NETHERLAND	NL
NETHERLAND ANTILLES	ZZ
NETHERLANDS	NL
NETHERLANDS ANTILLES	ZZ
NETHERLANDS ANTILLES CURACAO	CW
NETHERLANDS ANTILLES GUADELOUPE	GP
NETHERLANDS E INDIES	ID
NETHERLANDS HOLLAND	NL
NETHERLANDS KINGDOM OF THE	NL
NETHERLANDS NEDERLAND	NL
NETHERLANDS NEW GUINEA	ID
NETHERLANDS (THE)	NL
NETHERLANDS WEST INDIES	ZZ
NETHERLANDS W INDIES	ZZ
NETHERLAND W INDIES	ZZ
N ETHIOPIA	ET
NETH NEW GUINEA	ID
NETH N GUINEA	ID
N E TIBET	CN
N E TRANSVAAL	ZA
NETTET BELGIUM	BE
NEUMARKT GERMANY	DE
N E U S A	US
NEVADA	US
N E VENEZUELA	VN
NEVIS	KN
NEVIS ISLAND	KN
NEW BRITAIN	PG
NEW BRITAIN BISMARCK ARCHIP	PG
NEW BRITAIN I	PG
NEW BRITAIN IS	PG
NEW BRITIAN	PG
NEW BRITIAN I	PG
NEW BRUNSWICK	CA
NEWC	NC
NEW CALADONIA	NC
NEWCALEDONIA	NC
NEW CALEDONIA	NC
NEW CALEDONIA FR	NC
NEW CALEDONIA ISLANDS	NC
NEW CALEDONIA NEW CALEDONIA	NC
NEW CALIDORNIA	NC
NEWCASTLE UK	GB
NEWCASTLEUPONTYNE ENGLAND	GB
NEWFOUNDLAND	CA
NEW FOUNDLAND	CA
NEW GEORGIA	SB
NEW GRANADA	ZZ
NEW GRANADA COL	CO
NEW GRANADA COLUMBIA	CO
NEW GRENA	ZZ
NEW GRENADA	ZZ
NEW GRENADA ECUADOR	EC
NEW GRENADA ILLEG	ZZ
NEW GUIANA	ZZ
NEW GUIN	ZZ
NEW GUINEA	ZZ
NEW GUINEA ARU IS	ID
NEW GUINEA ARU IS	IN
NEW GUINEA AUSTRALIA NORTHERN TERRITORY QUEENSLAND	ZZ
NEW GUINEA BRITISH NEW GUINEA	PG
NEW GUINEA CAPTIVE	ZZ
NEW GUINEA CRANDALL	ZZ
NEW GUINEA INDONESIA	ID
NEW GUINEA N NEW GUINEA	ZZ
NEW GUINEA N W	ID
NEW GUINEA PAPUA	PG
NEW GUINEA S	ZZ
NEW GUINEA S E	PG
NEW GUINEA SOLOMONS	ZZ
NEW GUINEA TERR	ZZ
NEW GUINEA TERRITORY	ZZ
NEW GUINEA TERR PAPUA	PG
NEW HAMPSHIRE	US
NEW HAMPSHIRE USA	US
NEW HANOVER	PG
NEW HANOVER I	PG
NEW HANOVER IS	PG
NEW HAVEN USA	US
NEWHEBRIDE	VU
NEW HEBRIDES	VU
NEW HEBRIDES GROUP	VU
NEW HEBRIDES IS	VU
NEW HEBRIDES ISLAND	NZ
NEW HEBRIDES VANUATU	VU
NEW HEBRIDS	VU
NEW HERBRIDES	VU
NEW HIBRIDES	VU
NEW HOLLAND AUSTRALIA	AU
NEW HOLLAND WESTERN AUSTRALIA	AU
NEW IRELAND	PG
NEW IRELAND I	PG
NEW IRELAND IS	PG
NEW JERSEY	US
NEW JERSEY USA	US
NEW MEXICO	US
NEW MEXICO USA	US
NEW POMMERN	PG
NEW SIBERIA	RU
NEW SOUTH WALES	AU
NEW SOUTH WALES AUSTRALIA	AU
NEW SOUTH WALES SYDNEY AUSTRALIA	AU
NEW S WALES	AU
NEW WORLD	ZZ
NEW YORK	US
NEW YORK UNITED STATES	US
NEW YORK USA	US
NEWZEALAND	NZ
NEW ZEALAND	NZ
NEW ZEALAND AOTEAROA	NZ
NEW ZEALAND AUSTRALIA	ZZ
NEW ZEALAND CAPTIVE	NZ
NEW ZEALAND INTRODUCED	NZ
NEW ZEALAND IS	NZ
NEW ZEALAND REGION	NZ
NEW ZEALAND SEAS	NZ
NEW ZEALAND SUBANTARCTIC	NZ
NEW ZEALNAD	NZ
NEW ZEELAND	NZ
NEW ZELAND	NZ
N F	ZZ
NFK	NF
N FLORES I	ZZ
N FORMOSA	TW
N FORMOSA IS	TW
N FRANCE	FR
N G	ZZ
NGA	NG
NGAMALAND	BW
NGAMILAND	BW
N GERMANY	DE
N GERM NEW GUINEA	PG
N GER NEW GUINEA	PG
N GER NEW GUINEA COAST	PG
N G NEW GUINEA COAST	PG
N GRANADA	GD
N GREENLAND	GL
N GUATAMALA	GT
N GUATEMALA	GT
NGUI	PG
N GUINEA	ZZ
NHATRAND VIETNAM	VN
NHE	ZZ
NHEBRIDEN	VU
N HEBRIDES	VU
N HOLLAND	ZZ
NIA	NG
NIA FOU I	NZ
NIA FOU IS	NZ
NIAS	ID
NIAS I	ID
NIAS IS	ID
NIAS ISLAND	ID
NIC	NI
NICARAG	NI
NICARAGUA	NI
NICARAGUA COSTA RICA	ZZ
NICARAGUA NORTHERN NICARAGUA	NI
NICARAGUA OR COSTA RICA	ZZ
NICARAQUA	NI
NICARAUGA	NI
NICARAUGUA	NI
NICARUGA	NI
NICE FRANCE	FR
N ICELAND	IS
NICOBAR	IN
NICOBARES	IN
NICOBAR I	IN
NICOBAR IS	IN
NICOBAR ISLANDS	IN
NIEDERLANDE	NL
NIEDERSACHSEN	DE
NIG	NG
NIG	ZZ
NIGÃRIA	NG
NIGE	ZZ
NIGER	NE
NÍGER	NE
NIGERDOSSO	NE
NIGERHAUSA	NE
NIGERI	NG
NIGERIA	NG
NIGÉRIA	NG
NIGERIA EASTERN	NG
NIGERIA FULANI	NG
NIGERIA N	NG
NIGERIA NORD	NG
NIGERIA OFFSHORE	NG
NIGERIA S	NG
NIGERIA SUD	NG
NIGER TO SENEGAL	ZZ
NIGHTINGALE ISLAND	SH
NIHON	JP
NINAFOU	NZ
N INDIA	IN
NINIGO ISLANDS	PG
N IRAQ	IQ
NISHINOMIYA JAPAN	JP
NISSAN I	PG
NISSAN IS	PG
N ITALY	IT
NIU	NU
NIUE	NU
NIUÉ	NU
NIUE I	NU
NIUE ISLAND	NU
NJ	US
N J	US
N JAPAN	JP
N JAVA	ID
N KENYA	KE
N KOREA	KP
NL CF	NL
NLD	NL
N LIBYA	LY
N L MEX	MX
N LOMBOK	ID
N LOMBOK I	ID
N LOMOOK IS	ID
N LOO CHOO IS	JP
N LOOCHOO IS	JP
N LOO CHOV IS	JP
N LUZON I	PH
NM	US
N MADAGASCAR	MG
N MALAY PEN	ZZ
N MALAY PENIN	ZZ
N MALAY PENINS	ZZ
N MALAY PENINSULA	ZZ
N MALAY PENINSULAR	ZZ
N MANCHURIA	CN
N MARIANAS	MP
N MARIANNE IS	SC
N MAROCCO	MA
N MARQUESA IS	PF
N MESOPOTAMIA	ZZ
N MESOPTAMIA	ZZ
N MOLUCCAS	ID
N MOLUCCA S	ID
N MOLUCCA S IS	ID
N MONGOLIA	MN
N MOROCCO	MA
N MOZAMBIQUE	MZ
N MOZAMBIQUE B C AFRICA	MZ
N NATUNA I	ID
N NATUNA IS	ID
N NEW CALEDONIA	NC
N NEW GUINEA	ZZ
N NEW GUINEA COAST	ZZ
N N GUINEA	ZZ
N NIGER	NE
N NIGERIA	NG
N NORWAY	NO
N N W AUSTRALIA	AU
N NYASALAND MALAWI	MW
N N ZEALAND	NZ
NO ANGOLA	AO
NOBLE ISLAND	AU
NOCAKIRO IVORY COAST	CI
NO COUNTRY	ZZ
NO DATA	ZZ
N OF ANDAMAN IS	IN
N OF ARABIA	ZZ
N OF BALI IS	ID
N OF BORNEO	ZZ
N OF CELEBE	ID
N OF CELEBES	ID
N OF CELEBES IS	ID
N OF D NEW GUINEA	ID
N OF DU NEW GUINEA	ID
N OF FRANCE	FR
N OF GT KEY IS	ID
N OF GUINEA	ZZ
N OF HAWAIIAN IS	US
N OF JAVA	ID
N OF JAVA IS	ID
N OF LAPLAND	ZZ
N OF MADAGASCAR	MG
N OF MOLUCCA IS	ID
N OF NEW BRITAIN	PG
N OF NEW GUINEA	ZZ
N OF NEW HANOVER	PG
N OF NEW HANOVER IS	PG
N OF N GUINEA	ZZ
N OF POLAND	PL
N OF RUSSIA	RU
N OF SCOTLAND	GB
N OF SOLOMON IS	SB
N OF SUMBAWA	ID
N OF TUNIS	TN
NO FURTHER DATA	ZZ
NO FURTHER INFORMATION	ZZ
NO ICELAND	IS
NO LOCAL DATA	ZZ
NO LOCALITY	ZZ
NO LOCALITY DAT	ZZ
NO LOCALITY DATA	ZZ
NO MALAY PENIN	ZZ
NOME	US
NONE	ZZ
NO NIGERIA	NG
NO OTHER DATA	ZZ
NOR	NO
NORD CTE IV LATAHA AFR OUEST	CI
NORD CTIV	CI
NORD KANSU	CN
NORDKIVU ZAÃRE RÃPUBLIQUE DÃMOCRATIQUE DU CONGO	CD
NORD NOUVELLE-CALEDONIE	NC
NO RECORD	ZZ
NORFOLK	ZZ
NORFOLK I	NF
NORFOLK ÎLE	NF
NORFOLK ISL	NF
NORFOLKISLAND	NF
NORFOLK ISLAND	NF
NORFOLK ISLAND AUSTRALIA	NF
NORGE	NO
NORJA (NO)	NO
NORMANDY FRANCE	FR
NORSE BEACH PUERTO PEÃASCO SONORA MEXICO	MX
NORTH ABYSSINIA	ZZ
NORTH ADRIATIC SEA	ZZ
NORTH AFRICA	ZZ
NORTH ALGERIA	DZ
NORTH AMERICA	ZZ
NORTH AMERICA AND MEXICO	ZZ
NORTH AMERICA BY INFERENCE	ZZ
NORTH AMERICA CANADA	CA
NORTH AMERICA EASTERN	ZZ
NORTH AMERICA U S A	US
NORTH AMERICA WESTERN	ZZ
NORTH ANGOLA	AO
NORTH ATLANTIC	ZZ
NORTH ATLANTIC COAST	ZZ
NORTH ATLANTIC OCEAN	ZZ
NORTH AUSTRALIA	AU
NORTH BORNEO	ZZ
NORTHBRAZILIA	BR
NORTH BULGARIA	BG
NORTH BURMA	MM
NORTH CAMEROON	CM
NORTH CAMEROON HIGHLANDS	CM
NORTH CAROLINA	US
NORTH CAROLINA USA	US
NORTH CELEBES	ID
NORTH CENTRAL SYRIA	SY
NORTH CEYLON	LK
NORTH CHINA	CN
NORTH COAST D NEW GUINEA	ID
NORTH COAST OF GER PAPUA	PG
NORTH COAST OF ICELAND	IS
NORTH COREA	KP
NORTH DAKOTA UNITED STATES	US
NORTH DAKOTA USA	US
NORTH EAST AFRICA	ZZ
NORTH EAST AMERICA	ZZ
NORTH EAST COAST OF DUTCH NEW GUINEA	ID
NORTHEAST COAST OF ST VINCENT B W I	VC
NORTH EASTERN AFRICA	ZZ
NORTH EASTERN INDIA	IN
NORTHEASTERN PERU	PE
NORTHEASTERN UNITED STATES	US
NORTH EASTERN U S	US
NORTH EAST INDIA	IN
NORTHEAST IRAN	IR
NORTH EAST JAMAICA	JM
NORTH EAST OF IRELAND	IE
NORTHEAST PACIFIC	ZZ
NORTH ECAUDOR	EC
NORTH ECUADOR	EC
NORTH E GERMANY	DE
NORTH END OF SAN TOMÉ	ST
NORTHERN AFRICA	ZZ
NORTHERN ANGOLA	AO
NORTHERN AUSTRALIA	AU
NORTHERN BORNEO	ZZ
NORTHERN BULGARIA	BG
NORTHERN BURMA	MM
NORTHERN CAUCASUS	ZZ
NORTHERN CYPRUS	CY
NORTHERN ECUADOR	EC
NORTHERN ENGLAND U K	GB
NORTHERN EUROPE	ZZ
NORTHERN GEORGIA	GE
NORTHERN GREENLAND	GL
NORTHERN GRENADA	GD
NORTHERN GRENADA NICARAGUA	ZZ
NORTHERN GRENADINES B W I	VC
NORTHERN GUATEMALA	GT
NORTHERN INDIA	IN
NORTHERN IRELAND	GB
NORTHERN IRELAND U K	GB
NORTHERN LINE ISLANDS	KI
NORTHERN MADAGASCAR	MG
NORTHERN MALAWI	MW
NORTHERN MARIANA IS	MP
NORTHERN MARIANA ISLANDS	MP
NORTHERN MARIANA ISLANDS AND GUAM	ZZ
NORTHERN MARIANAS	MP
NORTHERN MARIANAS ISLAND	MP
NORTHERN MARIANAS ISLANDS	MP
NORTHERN MEXICO TO WESTERN PANAMA	ZZ
NORTHERN NEW GUINEA	ZZ
NORTHERN NICARAGUA	NI
NORTHERN NIGERIA	NG
NORTHERN NIGERIA CAMEROONS CAMEROON	ZZ
NORTHERN PAPUA	ZZ
NORTHERN PERU	PE
NORTHERN REGION	ZZ
NORTHERN RHODESIA	ZW
NORTHERN RHODESIA ZAMBIA	ZZ
NORTHERN SAINT MARTIN	MF
NORTHERN SENEGAL	SN
NORTHERN SOUTH AMERICA	ZZ
NORTHERN SUDAN	SD
NORTHERN SYRIA	SY
NORTHERN TANGANYIKA	TZ
NORTHERN TANZANIA	TZ
NORTHERN UNITED STATES U S A	US
NORTHERN URUGUAY	UY
NORTHERN URUNDI	BI
NORTHERN VENEZUELA	VE
NORTHERN VIRGINIA USA	US
NORTH ETHIOPIA	ET
NORTH EUROPE	ZZ
NORTH FORMOSA	TW
NORTH GERMAN NORTH SEA COAST GERMANY	DE
NORTH GERMANY	DE
NORTH GREENLAND	GL
NORTH GUATEMALA	GT
NORTH HOLLAND	NL
NORTH HOLLAND NETHERLANDS	NL
NORTH ICELAND	IS
NORTH INDIA	IN
NORTH IRELAND	GB
NORTH ITALY	IT
NORTH KAOLACK SENEGAL	SN
NORTH KOREA	KP
NORTH KOREA SOUTH KOREA	ZZ
NORTH LEBANON	LB
NORTH LOO CHOO IS	JP
NORTH MALAY PENIN	ZZ
NORTH MANCHURIA	CN
NORTH MOZAMBIQUE	MZ
NORTH NEW GUINEA	ZZ
NORTH NORWAY	NO
NORTH NYASALAND	MW
NORTH OF CELEBES	ID
NORTH OF ICELAND	IS
NORTH OF NEW GUINEA	ZZ
NORTH OF N GUINEA	ZZ
NORTH OF SCOTLAND	GB
NORTH OF VENEZUELA	VE
NORTH PACIFIC	ZZ
NORTH PACIFIC OCEAN	ZZ
NORTH PERZIÃ	IR
NORTH PORTUGAL	PT
NORTH RHODESIA	ZW
NORTH RHODESIA ZAMBIA	ZZ
NORTH RUSSIA	RU
NORTH SEA	ZZ
NORTH SEA ABERDEEN UK	GB
NORTH SEA ENGLAND U K	GB
NORTH SEA OR NORWEGIAN SEA	ZZ
NORTH SIAM	TH
NORTH SIBERIA	RU
NORTH SOMALILAND	SO
NORTH SOUTH AMERICA	ZZ
NORTH TIBET	CN
NORTH VEITNAM	VN
NORTH VENEZUELA	VE
NORTH VIETNAM	VN
NORTH VIETNAM CHINA	ZZ
NORTH WALES	GB
NORTH WALES U K	GB
NORTH WEST AFRICA	ZZ
NORTH WEST AMERICA	ZZ
NORTH WEST AMERICA U S A	US
NORTH WEST ATLANTIC	ZZ
NORTH WEST AUSTRALIA	AU
NORTHWEST AUSTRALIA	AU
NORTHWEST BALI	ID
NORTH WEST CENTRAL AUSTRALIA	AU
NORTHWEST COAST OF ST VINCENT B W I	VC
NORTH WESTERN AUSTRALIA	AU
NORTHWESTERN CRETE	GR
NORTH WESTERN EGYPT	EG
NORTHWESTERN HAWAIIAN ISLANDS	US
NORTH WESTERN INDIA	IN
NORTH WESTERN IRELAND	IE
NORTH WESTERN MADAGASCAR	MG
NORTHWESTERN TAIWAN	TW
NORTH WEST INDIA	IN
NORTHWEST IRAN	IR
NORTH WEST IRELAND ATLANTIC OCEAN	IE
NORTH WEST MADAGASCAR	MG
NORTH WEST OF IRELAND ATLANTIC OCEAN	IE
NORTH WEST PERSIA	ZZ
NORTHWEST REGION	ZZ
NORTHWEST SOUTH AMERICA	ZZ
NORTH WEST SPAIN	ES
NORUEGA	NO
NORVEGE	NO
NORVÈGE	NO
NORW	NO
NORWAY	NO
NORWAY NORGE	NO
NORWAY SWEDEN	ZZ
NORWAY SWEDEN FINLAND	ZZ
NORWAY SWEDEN FINLAND OR RUSSIA	ZZ
NORWEGIAN AND SWEDISH FRONTIER	ZZ
NORWEGIAN FJORD	NO
NORWEGIAN SEA	ZZ
NOR WEST AUSTRALIA	AU
NORWICH UK	GB
NO S LOO CHOO IS	JP
N O SPANJE	ES
NOT APPLICABLE	ZZ
NOT GIVEN	ZZ
NOTHERN MARIANA ISLANDS	MP
NOT RECORDED	ZZ
NOT REPORTED	ZZ
NOTTINGHAM UK	GB
NO TUNIS	TN
NOUMEA	NC
NOUVEAU MEXIQUE	US
NOUVELLE AMSTERDAM	ZZ
NOUVELLE CALEDONIE	NC
NOUVELLE CALÉDONIE	NC
NOUVELLE GUINÉE	ZZ
NOUVELLE GUINÉE OU INDONÉSIE	ZZ
NOUVELLE HOLLANDE	ZZ
NOUVELLES HÉBRIDES	VU
NOUVELLE ZELANDE	NZ
NOUVELLE ZÉLANDE	NZ
NOUVELLE ZÉLANDE ERREUR	ZZ
NOUZILLY FRANCE	FR
NOVAIA ZEMBYA	RU
NOVAIA ZEMLIA	RU
NOVAIA ZEMLIA I	RU
NOVAIA ZEMLYA	RU
NOVAJA ZEMBYA	RU
NOVA SCOTIA	CA
NOVA SCOTIA CANADA	CA
NOVA SCOTI HALIFAX CANADA	CA
NOVAYA SEMLYA	RU
NOVAYA ZEMBYA	RU
NOVAYA ZEMLYA	RU
NOVA ZELANDA	NZ
NOVA ZEMBLA	RU
NO W AUSTRALIA	AU
NO WEST CELEBES	ID
NPAC	ZZ
N PACIFIC OCEAN	ZZ
N PALESTINE	PS
N PAPUA	PG
N PERSIA	ZZ
N PERU	PE
N PHILIPPINES	PH
N PHILIPPINE S	PH
NPL	NP
N PORTUGAL	PT
N R	ZZ
N R BAROTSELAND	ZM
NR BAROTSELAND	ZM
NR BOUNDARY OF SWEDEN NORWAY AND FINLAND	ZZ
NR COAST OF GABOON	GA
N RHODESIA	ZW
N RHOD ESIA	ZW
N RHODESIA ZAMBIA	ZZ
NR NEW BRITAIN IS	PG
N R NORTHERN RHODESIA ZAMBIA	ZZ
NR SOMALILAND	SO
NRU	NR
N RUMANIA	RO
N RUSSIA	RU
N S	CA
N S AMERICA MEXICO TO VENEZUELA	ZZ
N SARDINIA	IT
N S CANADA	CA
N SCOTLAND	GB
N SIAM	TH
N SIBERIA	RU
N SIBERIA N OF ARTIC CIRCLE	RU
N SIBERIA S OF ARTIC CIRCLE	RU
N SOMALILAND	SO
NS ONE	ZZ
NSUGURU	ZZ
N SUMATRA	ID
NSW	AU
N S WALES	AU
N S W AUSTRALIA	AU
N SWEDEN	SE
N SYRIA	SY
N T	CA
N T	ZZ
N TANGANYIKA T	TZ
N TANGANYIKA TERR	TZ
N TANG TERR	TZ
N TANZANIA	TZ
N TASMANIA	AU
N THAILAND	TH
N TIBET	CN
N TRANSVAAL	ZA
N TUNESIA	TN
N TUNIS	TN
N TUNISIA	TN
N TURKEY	TR
NUBIA	ZZ
NUBIA ABYSSINIA	ZZ
NUBIA EGYPT	EG
NUEVA CALEDONIA	NC
NUEVA ECIJA PHILIPPINES	PH
NUEVA ZELANDA	NZ
N UGANDA	UG
NULL	ZZ
NV	US
N VEN	VE
N VENEZUELA	VE
N W	ZZ
N W AFRICA	ZZ
N WALES	GB
N W ALGERIA	DZ
N W AMERICA	ZZ
N W AMERICA U S A	US
N W ARABIA	ZZ
N W ARGENTINA	AR
N W AUSTRALIA	AU
N W BALI	ID
N W BORNEO	ZZ
N W BORNEO IS	ZZ
N W BRAZIL	BR
N W BR NEW GUINEA	PG
N W BURU	ID
N W CANADA	CA
N W CELEBES	ID
NW CELEBES	ID
N W CEYLON	LK
N W CHINA	CN
N W COAST BURU I	ID
N W COAST MADAGASCAR	MG
N W COAST OF MADAGASCAR	MG
N W COSTA RICA	CR
N W CRETE	GR
N W D NEW GUINEA	ID
N W DU NEW GUINEA	ID
N W ECUA	EC
NWECUADOR	EC
N W ECUADOR	EC
NW ECUADOR	EC
N WEST AUSTRALIA	AU
N WEST CEYLON	LK
N W FINLAND	FI
N W FOKIEN	CN
N W FRANCE	FR
N W GERMANY	DE
N W GREENLAND	GL
N W HAITI	HT
N W HONDURAS	HN
N W ICELAND	IS
N W INDIA	IN
NW IRAQ	IQ
N W IRELAND	IE
N W JAVA	ID
N W KENYA	KE
NW LEBANON	LB
N W MADAGASCAR	MG
N W MALAY PENINS	ZZ
N W MAROCCO	MA
N W MEXICO	MX
N W MONGOLIA	MN
N W MOROCCO	MA
N W NEPAL	NP
NW NEPAL	NP
N W NEW GUINEA	ID
N W NEW GUINEA	ZZ
N W N GUINEA	ID
N W OF BR NEW GUINEA	PG
N W OF CAROLINE IS	ZZ
N W OF GALAPAGOS IS	EC
N W OF MADAGASCAR	MG
N W OF NEW GUINEA	ID
N W OF N GUINEA	ID
N W PERSIA	ZZ
N W PERU	PE
N W RHODESIA	ZW
N W RHODESIA ZAMBIA	ZZ
N W RUSSIA	RU
N W SCOTLAND	GB
N W SIAM	TH
N W SOMALILAND	SO
N W SOUTH AMERICA	ZZ
NW SOUTH AMERICA	ZZ
N W SPAIN	ES
N W SPITZBERGEN	SJ
NW SYRIA	SY
N W T CANADA	CA
N W TUNIS	TN
N W TUNISIA	TN
N W UGANDA	UG
N W VENEZUELA	VE
NW VENEZUELA	VE
N W YUNNAN	CN
NY	US
NYAMILAND	BW
NYASALAND	MW
NYASALAND MALAWI	MW
NYASALAND RUNGWE	MW
NYASA MALAWI	MW
NYASSALAND	MW
NYASSA LAND MALAWI	MW
NYASSALAND MALAWI	MW
NYMPH CREEK YELLOWSTONE NATIONAL PARK USA	US
NYSSALAND	MW
N Z	NZ
NZAMILAND	MW
N ZEALAND	NZ
NZL	NZ
N Z NEW ZEALAND	NZ
NZ NEW ZEALAND	NZ
OAHU HAWAII	US
OAHU HAWAII USA	US
OBER EGYPT	EG
OBI I	ID
OBI IS	ID
OBI MAJOR I	ID
OCCUPIED PALESTINIAN TERRITORY	PS
OCEAN ANTARCTIQUE	ZZ
OCEAN ARCTIQUE	ZZ
OCEAN ATLANTIQUE	ZZ
OCEAN ATLANTIQUE CENTRE EST	ZZ
OCEAN ATLANTIQUE EST	ZZ
OCEAN ATLANTIQUE INTERTROPICAL	ZZ
OCEAN ATLANTIQUE NORD	ZZ
OCEAN ATLANTIQUE NORD EST	ZZ
OCEAN ATLANTIQUE NORD OUEST	ZZ
OCEAN ATLANTIQUE OUEST	ZZ
OCEAN ATLANTIQUE SUD	ZZ
OCEAN ATLANTIQUE SUD EST	ZZ
OCEAN ATLANTIQUE SUD OUEST	ZZ
OCEAN ATLANTIQUE TROPICAL	ZZ
OCEAN AUSTRAL	ZZ
OCEAN EQUINOXIAL	ZZ
OCEANIA	ZZ
OCEANIA MICRONESIA	FM
OCEANIC ISLANDS	ZZ
OCEANIE	ZZ
OCÉANIE	ZZ
OCEAN INDIEN	ZZ
OCÉAN INDIEN	ZZ
OCEAN INDIEN NORD	ZZ
OCEAN INDIEN OUEST	ZZ
OCEAN INDIEN SUD	ZZ
OCEAN INDIEN SUD OUEST	ZZ
OCÉAN INDIEN TERRITOIRE BRITANNIQUE DE L	IO
OCEAN INDO PACIFIQUA	ZZ
OCEAN ISLAND	ZZ
OCEAN PACIFIQUE	ZZ
OCEAN PACIFIQUE EST	ZZ
OCEAN PACIFIQUE NORD	ZZ
OCEAN PACIFIQUE NORD EST	ZZ
OCEAN PACIFIQUE OUEST	ZZ
OCEAN PACIFIQUE SUD	ZZ
OCEAN PACIFIQUE SUD EST	ZZ
OCEAN PACIFIQUE SUD OUEST	ZZ
OCEAN PACIFIQUE TROPICAL	ZZ
OCEAN STN NOVEMBER	ZZ
ODENSE DENMARK	DK
OEDELEM BELGIUM	BE
OELEGEM BELGIUM	BE
OENO ISLAND	PN
OFF AUSTRALIA	AU
OFF AUSTRALIAN COAST	AU
OFF BAHAMAS	BS
OFF CAPE TOWN SOUTH AFRICA	ZA
OFF CHILE	CL
OFF COAST OAHU HAWAII USA	US
OFF COAST OF CHILI	CL
OFF COAST OF CUBA	CU
OFF COAST OF HAWAII USA	US
OFF COAST OF OAHU HAWAII USA	US
OFF COAST OF S W MEXICO	MX
OFF EAST COAST OF PENINSULAR MALAYSIA	MY
OFF E COAST B E AFRICA	KE
OFF ECUADOR	EC
OFF E MADAGASCAR	MG
OFF ENGLAND	GB
OFF GALAPAGOS IS	EC
OFF ICELAND	IS
OFF JAPAN	JP
OFF JAPAN PACIFIC OCEAN	JP
OFF LAYSAN ISLE	US
OFF MADAGASCAR	MG
OFF MAURITIUS	MU
OFF MEXICO	MX
OFF N E COAST OF MADAGASCAR	MG
OFF NEWFOUNDLAND	CA
OFF NEW ZEALAND	NZ
OFF NORTH CAPE NORWAY	NO
OFF N W FRANCE	FR
OFF N W MADAGASCAR	MG
OFF N ZEALAND	NZ
OFF PANAMA	PA
OFF S CHINA	CN
OFF S ENGLAND	GB
OFF SOUTH AUSTRALIA	AU
OFF S W INDIES	ZZ
OFF THE COAST OF KANAGAWA PREFECTURE JAPAN	JP
OFF THE COAST OF NICE FRANCE	FR
OFF THE COAST OF NORTHERN CALIFORNIA USA	US
OFF THE IMMEDIATE COAST OF OAHU HAWAII USA	US
OFF TRISTAN DA CUNHA ISLAND	SH
OFF TRISTAN DA CUNHA ISLE	SH
OFF VENEZUELA	VE
OFF W AFRICA	ZZ
OFF WEST COAST OF MALAY PENINSULA	ZZ
OFF WESTERN SAHARA	EH
OFF WEST PATAGONIA PACIFIC OCEAN	CL
OFF W GREECE	GR
OFF W MEXICO	MX
OFF W SCOTLAND	GB
OFF W SUMATRA	ID
OFF YUGO SLAVIA	ZZ
O F S AFRICA	ZA
OGASAWARA IS	JP
OH	US
O HEBRIDES	GB
OHIO	US
OHIO UNITED STATES	US
OHIO USA	US
OISE FRANCE	FR
OK	US
OKAIA NEW ZEALAND	NZ
OKINAWA	JP
OKINAWA JAPAN	JP
OKINAWA TO SOUTH CHINA	ZZ
OKLAHOMA	US
OKLAHOMA TERRITORY	US
OKLAHOMA USA	US
OLD NORW	NO
OLD PROVIDENCE	CO
OLD PROVIDENCE I	CO
OLD PROVIDENCE ID	CO
OLD PROVIDENCE ISLAND	CO
OLD WORLD	ZZ
OLLIGNIES BELGIUM	BE
OLORUA I	FJ
OMAN	OM
OMÁN	OM
OMAN SOUTHERN	OM
OMN	OM
ONEIDA LAKE NEW YORK USA	US
ONGEA LEVU I	FJ
ONO ILAU I	FJ
ON S E COAST MADAGASCAR	MG
ONTARIO	CA
ONTARIO CANADA	CA
ONTARIO TORONTO CANADA	CA
OOSTERZELE BELGIUM	BE
OPEN OCEAN	ZZ
OPER VOLTA	BF
OR	US
ORANGE FREE ST	ZA
ORANGE FREE STATE	ZA
ORANGE F STATE	ZA
ORANGE R COLONY	ZA
ORCADES DU SUD I	AQ
ORE	US
OREBRO SWEDEN	SE
OREGON	US
OREGON USA	US
ORIENTAL	ZZ
ORIENTAL REPUBLIC OF URUGUAY	UY
ORINDA CALIFORNIA USA	US
ORINOCO RIVER REGION VENEZUELA	VE
ORKNEY	GB
ORKNEY I	GB
ORKNEY IS	GB
ORKNEY ISLANDS	GB
ORKNEY OR SHETLAND IS	GB
ORLÃANS FRANCE	FR
ORLY FRANCE	FR
ORNE ESTUARY NORMANDY FRANCE	FR
OSAKA JAPAN	JP
OSLO NORWAY	NO
OSSEMEERSEN GHENT BELGIUM	BE
OSS THE NETHERLANDS	NL
ÖSTERREICH	AT
OSWEGO COUNTY NEW YORK USA	US
OTAGO NEW ZEALAND	NZ
OTAHEITE TAHITI	PF
OTEGO	US
OTTAWA CANADA	CA
OUEST MAROCAIN	MA
OUEST MEDITERRANEE	ZZ
OUGANDA	UG
OUGANDA RÃGION DU PARC DE BWINDI	UG
OUHAM PENDE	CF
OUTER HEBRIDES	GB
OUTER MONGOLIA	MN
OUZBÉKISTAN	UZ
OVALAU I	FJ
OVERPELT BELGIUM	BE
OZEANIEN	ZZ
PAASEILAND	CL
PAC COAST OF COLOMBIA	CO
PACIFIC	ZZ
PACIFIC COAST OF COLOMBIA	CO
PACIFIC ISLANDS	ZZ
PACIFIC O	ZZ
PACIFIC OCEAN	ZZ
PACIFIC OCEAN EAST	ZZ
PACIFIC OCEANPACIFIC OCEAN	ZZ
PAC IS TR TR	UM
PAGO PAGO	AS
PAHANG	MY
PAÍSES BAJOS	NL
PAIWA TABACO ALBAY PHILIPPINES	PH
PAK	PK
PAKISTAN	PK
PAKISTÁN	PK
PAKISTAN AND BALUCHISTAN	PK
PAKISTAN ET AFGHANISTAN	ZZ
PAKISTAN OCCIDENTAL	PK
PAKISTAN OR INDIA	ZZ
PAKISTAN OU INDE	ZZ
PAKISTAN W	PK
PALAOS	PW
PALAU	PW
PALAU BELAU	PW
PALAU IDS	PW
PALAU IS	PW
PALAU IS BELAU	PW
PALAU ISLANDS	PW
PALAWAN	PH
PALAWAN I	PH
PALAWAN ISLAND	PH
PALAWAN PHILIPPINES	PH
PALEARCTIC	ZZ
PALEOS	ZZ
PALESTINE	PS
PALESTINE EGYPT	ZZ
PALESTINE ISRAEL	ZZ
PALESTINE JORDAN	JO
PALESTINE JORDAN	PS
PALESTINE JORDAN	ZZ
PALESTINE LEBANON	ZZ
PALESTINE SYRIA	ZZ
PALESTINIAN NATIONAL AUTHORITY	PS
PALESTINIAN TERRITORY	PS
PALESTINIEN OCCUPÉ TERRITOIRE	PS
PALESTINIEN TERRITOIRE	PS
PALMER ARCHIPELAGO	AQ
PALMYRA ATOLL	UM
PALMYRA ISLAND	UM
PALMYRA ISLANDS	UM
PAMAMA	PA
PAMEL BELGIUM	BE
PAN	PA
PANA	PA
PANABO DAVAO PHILIPPINES	PH
PANAM	PA
PANAMA	PA
PANAMÁ	PA
PANAMÀ	PA
PANAMA BAY	PA
PANAMA BRT GUIANA	ZZ
PANAMA CANAL	PA
PANAMA CANAL ZONE	PA
PANAMA CAPTIVE	PA
PANAMA CHIRIQUI	PA
PANAMA C Z	PA
PANAMA ILLEG	PA
PANAMA OR ARGENTINA	ZZ
PANAMA OR COLOMBIA	ZZ
PANAMA OR COSTA RICA	ZZ
PANAMA PANAMA CANAL ZONE	PA
PANAMA PROBABLY	PA
PANAMA R P	PA
PANANMA	PA
PANAY I	PH
PANGIL LAGUNA PHILIPPINES	PH
PANTAR I	ID
PANTAR IS	ID
PAPAUA NEW GUINEA	PG
PAPAU NEW GUINEA	PG
PAPOUASIE	ZZ
PAPOUASIE NOUVELLE GUINEE	PG
PAPOUASIE NOUVELLE GUINÉE	PG
PAPUA	ZZ
PAPUA AND NEW GUINEA	ZZ
PAPUA C D NEW GUINEA	PG
PAPUA CENT D NEW GUINEA	PG
PAPUA CENTRAL DIV NEW GUINEA	PG
PAPUA MAINLAND	PG
PAPUA NEW GUIENA	PG
PAPUA NEW GUIN	PG
PAPUANEWGUINEA	PG
PAPUA NEW GUINEA	PG
PAPUANEW GUINEA	PG
PAPUA NEW GUINEA OR SOUTH PACIFIC OCEAN	ZZ
PAPUA NEW GUINEA POSSIBLY	PG
PAPUA NG	PG
PAPUA N GUIN	PG
PAPUA NOVA GUINEA	PG
PAPÚA NUEVA GUINEA	PG
PAPUA W D NEW GUINEA	PG
PAQAPUA NEW GUINEA	PG
PAQUES I	CL
PAR	ZZ
PARA	PY
PARAGUAI	PY
PARAGUARY	PY
PARAGUAY	PY
PARAGUAYAN	PY
PARAGUAY OR ARGENTINA	ZZ
PARAGUAY OR ARGENTINE N OF	ZZ
PARANA	BR
PARANA STATE BRAZIL	BR
PARAQUANA	VE
PARAQUAY	PY
PARECE VELA JAPAN	JP
PASKOV CZECH REPUBLIC	CZ
PASSAU GERMANY	DE
PATAGONIA	ZZ
PATAGONIA FALKLAND IS	FK
PATAGONIA FALKLAND IS	ZZ
PATAGONIA SOUTH AMERICA	ZZ
PATAGONIA URUGUAY	ZZ
PAULINENAUE BRANDENBURG GERMANY	DE
PAUMOTU IS	PF
PAUMOTU ISLANDS	PF
PAUMOTUS	PF
PAWA MALINAW ALBAY PHILIPPINES	PH
PAYS BAS	NL
PAYS DES COMALIS	ZZ
PAYS NON IDENTIFIÉ	ZZ
PAYS NON IDENTIFIÉ AFRIQUE	ZZ
PAYS NON IDENTIFIÉ AMÉRIQUE	ZZ
PAYS NON IDENTIFIÉ AMÉRIQUE CENTRALE	ZZ
PAYS NON IDENTIFIÉ AMÉRIQUE DU NORD	ZZ
PAYS NON IDENTIFIÉ AMÉRIQUE DU SUD	ZZ
PAYS NON IDENTIFIÉ ANTARCTIQUE	ZZ
PAYS NON IDENTIFIÉ ASIE	ZZ
PAYS NON IDENTIFIÉ EUROPE	ZZ
PAYS NON IDENTIFIÉ OCÉANIE	ZZ
PCN	PN
PEA	ZZ
P E A	ZZ
P E AFRICA	ZZ
PEGU	PE
PELEW I	PW
PELEW IS	PW
PELEW I S	PW
PELEW ISLANDS	PW
PELING IS	ID
PEMBA IS	TZ
PENANA	ZZ
PENINSULA OF SIERRA LEONE	SL
PENINSULAR MALAYSIA	MY
PENINSULAR MALYSIA	MY
PENINSULAR SIAM	TH
PENINSULAR THAILAND	TH
PENINSULA TIHANY HUNGARY	HU
PENNSYLVANIA	US
PENNSYLVANIA STATE UNIVERSITY USA	US
PENNSYLVANIA USA	US
PENRHYN ISLAND	CK
PENTLAND SKERRIES	GB
PEOPLES REP OF CHINA	CN
PEOPLE S REPUBLIC OF CHINA	CN
PEOPLES REPUBLIC OF CHINA	CN
PEOPLES REPUBLIC OF THE CONGO	CG
PER	PE
PERAK	MY
PERNAMBUCO BRAZIL	BR
PEROU	PE
PÉROU	PE
PEROU BOLIVIE	ZZ
PÉROU OU BOLIVIE	ZZ
PÉROU PERU	PE
PERSE [IRAN]	IR
PERSIA	ZZ
PERSIA BALUCHISTAN	ZZ
PERSIAN BALAUCHISTAN	ZZ
PERSIAN BALUCHISTAN	ZZ
PERSIAN BELUCHISTAN	ZZ
PERSIAN GULF	ZZ
PERTH AUSTRALIA	AU
PERTH WESTERN AUSTRALIA	AU
PERU	PE
PERÚ	PE
PERU BOLIVIA	ZZ
PERU BOLIVIA BRAZIL	ZZ
PERU BRAZIL	ZZ
PERU CHILE	ZZ
PERU E	PE
PERU ECUADOR	ZZ
PERU MEXICO	ZZ
PERU N	PE
PERU OR BRAZIL	ZZ
PERU OR CHILE	ZZ
PERU OR ECUADOR	ZZ
PERU S	PE
PERU SE	PE
PERUVIAN AMAZONS	PE
PERU WITH THE P UNDERLINED GUADELOUPE	PE
PESCADORE IS	TW
PETER ISLAND BVI	VG
PETIT ENGHIEN BELGIUM	BE
PETIT MARTINIQUE	MQ
PET TRADE	ZZ
P GUIANEA	PG
PHI	PH
PHIL	PH
PHILIIPPINES	PH
PHILILPPINES	PH
PHILIP	PH
PHILIPIJNEN	PH
PHILIPINES	PH
PHILIPPINE	PH
PHILIPPINEI	PH
PHILIPPINE I	PH
PHILIPPINE ID	PH
PHILIPPINE IDS	PH
PHILIPPINE IS	PH
PHILIPPINE ISL	PH
PHILIPPINE ISLAND	PH
PHILIPPINE ISLANDS	PH
PHILIPPINE ISLAND S	PH
PHILIPPINE ISLANDS PHILIPPINES	PH
PHILIPPINE ISLS	PH
PHILIPPINE IS NO	PH
PHILIPPINE PHILIPPINES	PH
PHILIPPINES	PH
PHILIPPINE S	PH
PHILIPPINES ET MALAISIE	ZZ
PHILIPPINES I	PH
PHILIPPINES IS	PH
PHILIPPINES ISL	PH
PHILIPPINES OR INDONESIA	ZZ
PHILL	PH
PHILLIPENS	PH
PHILLIPINE	PH
PHILLIPINE IDS	PH
PHILLIPINE IS	PH
PHILLIPINE ISLANDS	PH
PHILLIPINES	PH
PHILLIPPINE ID	PH
PHILLIPPINE ISLANDS	PH
PHILLIPPINES	PH
PHILPPINES	PH
PHL	PH
PHOENIX GROUP	KI
PHOENIX I	KI
PHOENIX IS	KI
PHOENIX ISLAND	KI
PHOENIX ISLANDS	KI
PHRHER	ZZ
P I	ZZ
PIETERMARITZBURG KWAZULUNATAL SOUTH AFRICA	ZA
PIET RETIEF MPUMALANGA SOUTH AFRICA	ZA
PILIPINAS	PH
PINAR DEL RIO	CU
PINELLAS CO	US
PINGTUNG TAIWAN	TW
PINI I	ID
PINI IS	ID
P IS	ZZ
PISANG ISLAND	IN
PITCAIRN	PN
PITCAIRN I	PN
PITCAIRN ISL	PN
PITCAIRN ISLAND	PN
PITCAIRN ISLANDS	PN
PITTEM BELGIUM	BE
PLANTS OF CHINA	CN
PLANTS OF USA	US
PLATTE RIVER FISH HATCHERY MICHIGAN USA	US
PLILIPPIJNEN	PH
PLUMCHIAU FRANCE	FR
PLURINATIONAL STATE OF BOLIVIA	BO
PLUSSEE HOLSTEIN	DE
PLW	PW
PNG	PG
PNG BI	PG
PNG BO	PG
PNG CB	PG
PNG EH	PG
PNG ES	PG
PNG GL	PG
PNG MI	PG
PNG NB	PG
PNG NG	PG
PNG NI	PG
PNG NT	PG
PNG SI	PG
PNG TI	PG
PNG WE	PG
PNG WN	PG
PNG WS	PG
POHNPEI	FM
POL	PL
POLAND	PL
POLAND GERMANY	ZZ
POLAND POLSKA	PL
POLANGUI ALBAY PHILIPPINES	PH
POLEN	PL
POLILLO IS	PH
POLINESIA FRANCESA	PF
POLINYA DEL JUCAR VALENCIA SPAIN	ES
POLLARE BELGIUM	BE
POLOGNE	PL
POLONIA	PL
POLÒNIA	PL
POLYNESIA	ZZ
POLYNESIÃ	PF
POLYNESIE	ZZ
POLYNÉSIE	ZZ
POLYNÉSIE FRANÇAISE	PF
POMERANIA	DE
POMMERN	PG
PONAPE	FM
PONAPE I	FM
PONAPÉ I	FM
PONT LEVÃQUE NORMANDY FRANCE	FR
PORT	PT
PORTANGOLA	AO
PORT CRISTO MALLORCA SPAIN	ES
PORT E AFRICA	MZ
PORT GUINEA	GW
PORT HUENEME USA	US
PORT ORCHARD WASHINGTON USA	US
PORTO RICA	PR
PORTO RICO	PR
PORTO RICO PUERTO RICO	PR
PORT SUDAN	SD
PORTU E AFRICA	MZ
PORTUGAL	PT
PORTUGAL NORTHERN	PT
PORTUGAL PROVINCE OF ALGARVE	PT
PORTUGAL SPAIN	ZZ
PORTUG E AFRICA	MZ
PORTUGESE AFRICA	MZ
PORTUGESE CONGO	AO
PORTUGESE E AFRICA	MZ
PORTUGESE GUINEA	GW
PORTUGESE INDIA	IN
PORTUGESE ZAMBIA	ZM
PORTUGIES GUINEA	GW
PORTUGUESE	ZZ
PORTUGUESE AFRICA	MZ
PORTUGUESE CONGO	AO
PORTUGUESE E AFRICA	MZ
PORTUGUESE E AFRICA MOZAMBIQUE	MZ
PORTUGUESE EAST AFR	MZ
PORTUGUESEEASTAFRICA	MZ
PORTUGUESE EAST AFRICA	MZ
PORTUGUESE EAST AFRICA MOZAMBIQUE	MZ
PORTUGUESE GUIANA	GW
PORTUGUESE GUINEA	GW
PORTUGUESE GUINEA GUINEA	GW
PORTUGUESE GUINEA GUINEA BISSAU	GW
PORTUGUESE REPUBLIC	PT
PORTUGUESE W AFRICA	AO
PORTUGUESE WEST AFRICA	AO
PORVOO FINLAND	FI
POSSIBLY FED ST OF MICRONESIA	FM
POSSIBLY HONDURAS	HN
POSSIBLY JAMAICA	JM
POSSIBLY MALTA	MT
POSSIBLY MEXICO	MX
POSSIBLY NEW ZEALAND	NZ
POSSIBLY PALAU	PW
POSSIBLY PHILIPPINES	PH
POSSIBLY SOUTH AFRICA	ZA
POTOMAC RIVER USA	US
POTTES BELGIUM	BE
POTUGAL	PT
P P INDIA	IN
PRATHET THAI	TH
P R CHINA	CN
P R CONGO	CG
PRESTON UK	GB
PRESUMABLY FRENCH GUIANA	GF
PRESUMABLY MEXICO	MX
PRESUMED AUSTRALIA	AU
PRESUMED ECUADOR	EC
PRESUMED LAOS	LA
PRESUMED NEPAL	NP
PRESUMED NEW GUINEA	ZZ
PRESUMED PAPUA NEW GUINEA	PG
PRESUMED TERR NEW GUINEA	ZZ
PRESUMED TONGA	TO
PRESUMED USA	US
PRESUMED VIETNAM	VN
PRESUMED WESTERN SAMOA	WS
PRETORIA	ZA
PRETORIA SOUTH AFRICA	ZA
PRI	PR
PRIBILOF ISLANDS	US
PRINCE EDOUARD I	CA
PRINCE EDWARD I	CA
PRINCE EDWARD IS	CA
PRINCE EDWARD ISLAND CAPE	CA
PRINCE GEORGE S	US
PRINCE OF WALES ISLAND	US
PRINCES I	ZZ
PRINCIPE I	ST
PRINCIPE IS	ST
PRINCIPE ISLAND	ST
PRK	KP
PROBABLEMENT DJIBOUTI	DJ
PROBABLEMENT DU SURINAM	SR
PROBABLEMENT EST DES MADAGASCAR	MG
PROBABLEMENT ETATS UNIS	US
PROBABLEMENT ÎLE MAURICE	MU
PROBABLEMENT LA RÉUNION	RE
PROBABLEMENT SUD DE LA FRANCE OU ESPAGNE	ZZ
PROBABLEMENT URUGUAY	UY
PROBABLY CHINA	CN
PROBABLY COLOMBIA	CO
PROBABLY FORMOSA	TW
PROBABLY FROM JAVA	ID
PROBABLY FROM NIGERIA	NG
PROBABLY FROM N W SCOTLAND U K	GB
PROBABLY FROM W OF N AMERICA	ZZ
PROBABLY GUATEMALA	GT
PROBABLY HAITI	HT
PROBABLY ISOLATED IN NORWAY	NO
PROBABLY KOREA	KR
PROBABLY MADAGASCAR	MG
PROBABLY MEDITERRANEAN	ZZ
PROBABLY MOROCCO	MA
PROBABLY MOZAMBIQUE	MZ
PROBABLY NIGER OR GAMBIA	ZZ
PROBABLY NORTH AMERICAN	ZZ
PROBABLY SIERRA LEONE BUT UNCERTAIN	SL
PROBABLY SINGAPORE	SG
PROBABLY SOLOMON IS	SB
PROBABLY SOUTH AMERICA	ZZ
PROBABLY THAILAND	TH
PROBABLY TRINIDAD	TT
PROBABLY USA	US
PROBABLY U S A SOUTH	US
PROB AUSTRALIA	AU
PROB S AUSTRALIA	AU
PROB W OF N AMERICA	ZZ
PROVIDENCIA	CO
PROVIDENCIA ISLAND	CO
PROVIDENCIALES	CO
PROV NIGERIA	NG
PRT	PT
PRUNE	ZZ
PRUSSE	ZZ
PRUSSE OCCIDENTALE	ZZ
PRUSSIA	ZZ
PRY	PY
PSE	PS
P SIAM	TH
P SIAM PENINSULAR	TH
PSKOV	RU
PT GAWLER SOUTH AUSTRALIA	AU
PUE	PR
PUER	PR
PUERTE RICO	PR
PUERTO	PR
PUERTO RICA	PR
PUERTORICO	PR
PUERTO RICO	PR
PUERTO RICO USA	PR
PUERTO RIO	PR
PULAU GAYA	MY
PULAU ISLAND	PW
PULAU LAUT I	ID
PUNJAB PAKISTAN	PK
PUNTARENAS	ZZ
PUOLA (PL)	PL
PUSAKANEGARA WJAVA INDONESIA	ID
PYF	PF
PYRENÃES ORIENTALES FRANCE	FR
PYRENEES	ZZ
QAT	QA
QATAR	QA
QATAR ARABIA	QA
QLD	AU
QUADELOUPE	GP
QUEBEC	CA
QUEBEC CANADA	CA
QUEEN CHARLOTTE IS	CA
QUEEN CHARLOTTE SOUND	ZZ
QUEENSLAND	AU
QUEENSLAND AUSTRALIA	AU
QUITO	EC
RÃDESHEIM GERMANY	DE
RAISED DIED IN CAPTIVITY AT NO ILLINOIS UNIVERSITY	US
RAISED IN CAPTIVITY ENDEMIC TO AUSTRALIA	ZZ
RAMONVILLESAINTAGNE HAUTEGARONNE FRANCE	FR
RAMSKAPELLE BELGIUM	BE
RANGWE	KE
RANSKA (FR)	FR
RAPA	PF
RAPA IS	PF
RAPA ISLAND	PF
RÃPUBLIQUE CENTRAFRICAINE	CF
RÃPUBLIQUE CENTRAFRICAINE OUBANGUI	CF
RÃPUBLIQUE CENTRAFRICAINE RÃPUBLIQUE DU CONGOBRAZZAVILLE	CG
RÃPUBLIQUE DE GUINÃE	GN
RÃPUBLIQUE POPULAIRE DU CONGO	CG
RÃPUBLIQUE POPULAIRE DU CONGO AUTOUR DU VILLAGE DE MOUMPOUTOU LE LONG DE LA RIVIÃRE	CG
RÃPUBLIQUE POPULAIRE DU CONGO AUTOUR DUVILLAGE DE MOUMPOUTOU LE LONG DE LA RIVIÃRE	CG
RÃUNION	RE
RAWANDA	RW
RCA	CF
R C A	CF
RDC	CD
RECIFE BRAZIL	BR
REDONDA IS	AG
REDONDA ISLAND	AG
RED SEA	ZZ
RED SEA EGYPT	EG
REEF I	SB
REGION IV COQUIMBO	CL
REGION OF NEW GUINEA	ZZ
REGION XI AYSÉN	CL
REGION XII MAGALLANES Y ANTÁRTICA CHILENA	CL
REGNE UNIT	GB
REG OF AVALO CASPIA	ZZ
REINO UNIDO	GB
REP DEL URUGUAY	UY
REP DEMOCRATIQUE DU CONGO	CD
REP GEORGIA	GE
REP MALAGASIA	MG
REP OF CONGO	CG
REP OF IRELAND	IE
REP OF PANAMA	PA
REP OF S AFRICA	ZA
REP OF SOUTH AFRICA	ZA
REP OF THE CONGO	CG
REP SOUTH AFRICA	ZA
REPÚBLICA ÁRABE SAHARAUI	EH
REPÚBLICA CENTROAFRICANA	CF
REPÚBLICA CHECA	CZ
REPÚBLICA COOPERATIVA DE GUYANA	GY
REPÚBLICA DE CHAD	TD
REPÚBLICA DE COLOMBIA	CO
REPÚBLICA DE COSTA RICA	CR
REPÚBLICA DEL CONGO	CG
REPUBLICA DEL URUGUAY	UY
REPÚBLICA DE MACEDONIA	MK
REPÚBLICA DEMOCRÁTICA DEL CONGO	CD
REPÚBLICA DE SUDÁN	SD
REPUBLICA DOMINICA	DO
REPUBLICA DOMINICANA	DO
REPÚBLICA DOMINICANA	DO
REPUBLIC GEORGIA	GE
REPUBLIC OF ALBANIA	AL
REPUBLIC OF ANGOLA	AO
REPUBLIC OF AUSTRIA	AT
REPUBLIC OF BENIN	BJ
REPUBLIC OF BOLIVIA	BO
REPUBLIC OF BOTSWANA	BW
REPUBLIC OF BURUNDI	BI
REPUBLIC OF CAMEROON	CM
REPUBLIC OF CAPE VER	CV
REPUBLIC OF CAPE VERDE	CV
REPUBLIC OF CHILE	CL
REPUBLIC OF CHINA	CN
REPUBLIC OF COLOMBIA	CO
REPUBLIC OF CONGO	CG
REPUBLIC OF COSTA RICA	CR
REPUBLIC OF CÔTE D IVOIRE	CI
REPUBLIC OF CROATIA	HR
REPUBLIC OF CUBA	CU
REPUBLIC OF CYPRUS	CY
REPUBLIC OF ECUADOR	EC
REPUBLIC OF EL SALVADOR	SV
REPUBLIC OF FIJI	FJ
REPUBLIC OF FRANCE	FR
REPUBLIC OF GEORGIA	GE
REPUBLIC OF GHANA	GH
REPUBLIC OF GUATEMALA	GT
REPUBLIC OF GUINEA	GN
REPUBLIC OF HONDURAS	HN
REPUBLIC OF ICELAND	IS
REPUBLIC OF INDIA	IN
REPUBLIC OF INDONESIA	ID
REPUBLIC OF IRAQ	IQ
REPUBLIC OF IRELAND	IE
REPUBLIC OF KENYA	KE
REPUBLIC OF KIRIBATI	KI
REPUBLIC OF KOREA	KR
REPUBLIC OF LEBANON	LB
REPUBLIC OF LIBERIA	LR
REPUBLIC OF MACEDONIA	MK
REPUBLIC OF MADAGASCAR	MG
REPUBLIC OF MALAWI	MW
REPUBLIC OF MALDIVES	MV
REPUBLIC OF MALTA	MT
REPUBLIC OF MAURITIUS	MU
REPUBLIC OF MOLDOVA	MD
REPUBLIC OF MOZAMBIQUE	MZ
REPUBLIC OF NAMIBIA	NA
REPUBLIC OF NAURU	NR
REPUBLIC OF NICARAGUA	NI
REPUBLIC OF NIGER	NE
REPUBLIC OF PALAU	PW
REPUBLIC OF PANAMA	PA
REPUBLIC OF PARAGUAY	PY
REPUBLIC OF PERU	PE
REPUBLIC OF RWANDA	RW
REPUBLIC OF S AFRICA	ZA
REPUBLIC OF SENEGAL	SN
REPUBLIC OF SEYCHELLES	SC
REPUBLIC OF SIERRA LEONE	SL
REPUBLIC OF SOMALIA	SO
REPUBLIC OF SOUTH AFRICA	ZA
REPUBLIC OF SUDAN	SD
REPUBLIC OF THE CONGO	CG
REPUBLIC OF THE CONGOA	CG
REPUBLIC OF THE FIJI ISLANDS	FJ
REPUBLIC OF THE GAMBIA	GM
REPUBLIC OF THE MARSHALL ISLANDS	MH
REPUBLIC OF THE PHILIPPINES	PH
REPUBLIC OF THE PHILLIPINES	PH
REPUBLIC OF THE SUDAN	SD
REPUBLIC OF TRINIDAD AND TOBAGO	TT
REPUBLIC OF TURKEY	TR
REPUBLIC OF UGANDA	UG
REPUBLIC OF VIETNAM RVN	VN
REPUBLIC OF ZAMBIA	ZM
REPUBLIC OF ZIMBABWE	ZW
REPUBLIC TRINIDAD AND TOBAGO	TT
RÉPUBLIQUE ARABE SYRIENNE	SY
RÉPUBLIQUE BOLIVARIENNE DU VENEZUELA	VE
REPUBLIQUE CENTRAFRICAINE	CF
RÉPUBLIQUE CENTRAFRICAINE	CF
RÉPUBLIQUE D AFRIQUE DU SUD	ZA
REPUBLIQUE DE BURIATIE	RU
RÉPUBLIQUE DE CORÉE	KR
RÉPUBLIQUE DE DJIBOUTI	DJ
RÉPUBLIQUE DE GÉORGIE	GE
RÉPUBLIQUE DE GUINÉE	GN
RÉPUBLIQUE DÉMOCRATIQUE DE SAO TOMÉ ET PRINCIPE	ST
RÉPUBLIQUE DÉMOCRATIQUE DU CONGO	CD
RÉPUBLIQUE DÉMOCRATIQUE POPULAIRE LAO	LA
RÉPUBLIQUE DE MOLDOVA	MD
RÉPUBLIQUE DES FIDJI	FJ
RÉPUBLIQUE DES ÎLES FIDJI	FJ
RÉPUBLIQUE DES SEYCHELLES	SC
RÉPUBLIQUE DE VANUATU	VU
RÉPUBLIQUE DOMINICAINE	DO
RÉPUBLIQUE DU CAP VERT	CV
RÉPUBLIQUE DU CONGO	CG
RÉPUBLIQUE DU KIRIBATI	KI
RÉPUBLIQUE DU VANUATU	VU
RÉPUBLIQUE ET REPTILES COLLECTÉS EN RÉPUBLIQUE DES SEYCHELLES	SC
RÉPUBLIQUE ISLAMIQUE D IRAN	IR
REPUBLIQUE POPULAIRE DE CHINE	CN
RÉPUBLIQUE POPULAIRE DE CHINE	CN
RÉPUBLIQUE POPULAIRE DÉMOCRATIQUE DE CORÉE	KP
RÉPUBLIQUE POPULAIRE DU BÉNIN	BJ
RÉPUBLIQUE SUD AFRICAINE	ZA
REPUBLIQUE TCHEQUE	CZ
RÉPUBLIQUE TCHÈQUE	CZ
RÉPUBLIQUE UNIE DE TANZANIE	TZ
REPUB OF THE CONGO	CG
RESURRECTION BAY NEAR SEWARD ALASKA	US
RETIE BELGIUM	BE
REU	RE
REUNION	RE
REUNIÓN	RE
RÉUNION	RE
REUNION I	RE
REUNION I BOURBON	RE
REUNION IS	RE
REUNION ISLAND	RE
REUNION ISLAND S	RE
RÉUNION OU MADAGASCAR	ZZ
REVILLAGIGEDO	ZZ
REVILLAGIGEDO I	MX
REVILLA GIGEDO IS	MX
REVILLAGIGEDO IS	ZZ
REVILLAGIGEDO ISLANDS	MX
REVILLAGIGEDOS IS	ZZ
RHEINLAND-PFALZ	DE
RHODE ISLAND	US
RHODE ISLAND USA	US
RHODESIA	ZW
RHODESIA SE	ZW
RHODESIA SOUTH	ZW
RHODESIA ZAMBIA	ZM
RHODESIA ZAMBIA ZIMBABWE	ZZ
RHODESIA ZIMBABWE	ZW
RHODÉSIE	ZW
RHODIS I	GR
RHODOS GREECE	GR
RIJKEVORSEL BELGIUM	BE
RILLAAR BELGIUM	BE
RIMGWE	TZ
RINGVASSÃY NORWAY	NO
RIO DE HANABANA	CU
RIO DE JANEIRO BRAZIL	BR
RIRRILET COSTA RICA	CR
RIU KIU ISLANDS	JP
RIUKIU ISLANDS	JP
RÏUNION	RE
RIVER AVON HAMPSHIRE ENGLAND	GB
RIVER CLETTER UK	GB
RIVER ELBE	ZZ
RIVER MOSCOW RUSSIA	RU
RIVER MOSCWA FORMER USSR	RU
RIVER PLYM DARTMOOR	GB
RIVER SPEY ABERLOUR SCOTLAND	GB
RIVER WEENDE GÃTTINGEN GERMANY	DE
RIVER WESER GERMANY	DE
RIVER WEY GUILFORD SURREY UK	GB
RIVER YVETTE FRANCE	FR
ROCKDALE UK	GB
RODESIA	ZW
RODRIGUES	MU
RODRIGUES IS INDIAN OCEAN	MU
RODRIGUES ISLAND	MU
RODRIGUEZ	MU
RODRIGUEZ I	MU
RODRIGUEZ IS	MU
RODRIGUEZ ISLAND	MU
RODRIQUES	MU
RODRIQUEZ ISLAND	MU
ROEMENIÃ	RO
ROEMENIE	RO
ROMAH ISLAND	ZZ
ROMA IS	AU
ROMANI	RO
ROMANIA	RO
ROME	IT
ROMÊNIA	RO
ROMINA	RO
RONCADOR BANK	CO
RONCADOR BANKS	CO
ROODEPLAAT PRETORIA SOUTH AFRICA	ZA
ROOKE I	PG
ROOKE I BISMARCK ARCHIP	PG
ROOK I	PG
ROOK I BISMARCK ARCH	PG
ROOK I BISMARCK ARCHIP	PG
ROOK I E OF GER NEW GUINEA	PG
ROOSDAAL BELGIUM	BE
ROSS DEPENDENCY	AQ
ROSSEL IS	PG
ROSSIA	RU
ROSS SEA	AQ
ROTHAMSTED UK	GB
ROTORUA NEW ZEALAND	NZ
ROTTERDAM	NL
ROTUMA	FJ
ROTUMAH	FJ
ROTUMAH I	FJ
ROU	RO
ROUMAINIA	RO
ROUMANIA	RO
ROUMANIAROMANIA	RO
ROUMANIA ROMANIA	RO
ROUMANIE	RO
ROUND ISLAND	ZZ
ROUVEROY BELGIUM	BE
ROYAL RESEARCH STATION OF GORSEM SINTTRUIDEN BELGIUM	BE
ROYAUME DES TONGA	TO
ROYAUME DES ZOULOUS	ZA
ROYAUME DE TONGA	TO
ROYAUME D OMAN	OM
ROYAUME UNI	GB
R P	ZZ
R PAL	ZZ
R S A SOUTH AFRICA	ZA
RUANDA	RW
RUDDERVOORDE BELGIUM	BE
RUFISQUE NEAR DAKAR SENEGAL	SN
RUMANIA	RO
RUMENIA	RO
RUNGUE	TZ
RUNGWE	TZ
RUNGWE MISSION	TZ
RUNION ISLAND	RE
RUOTSI (SE)	SE
RUS	RU
RUSIA	RU
RUSLAND	RU
RUSS	RU
RUSSELL ISLANDS	SB
RUSSIA	RU
RÚSSIA	RU
RUSSIA ASIA	RU
RUSSIA CHINA	ZZ
RUSSIA CIS FORMER USSR	RU
RUSSIA EUROPE	RU
RUSSIA FAR EAST	RU
RUSSIA FEDERATION	RU
RUSSIA FINLAND	ZZ
RUSSIA KAZAKHSTAN	ZZ
RUSSIAN ALTAI	RU
RUSSIAN FED	RU
RUSSIAN FEDERATION	RU
RUSSIAN FEDERATION (THE) (RUSSIA)	RU
RUSSIAN SOVIET FEDERATED SOCIALIST REPUBLIC	RU
RUSSIAN TURKESTAN	ZZ
RUSSIA OR MONGOLIA	ZZ
RUSSIA ROSSIYA	RU
RUSSIA SOUTH	RU
RUSSIA TURKEY	ZZ
RUSSIA USA	ZZ
RUSSIA USSR	RU
RUSSIA U S S R	RU
RUSSIA VOLGA DELTA	RU
RUSSIE	RU
RUSSIE FÉDÉRATION DE	RU
RUSSIE RUSSIA	RU
RUSSIJA	RU
RUTEGAMA BURUNDI	BI
R ÜUNION	RE
RUWENZORI MOUNTAINS	CD
RWA	RW
RWANDA	RW
RWANDA BURUNDI	ZZ
RWANDA NORD	RW
RWANDA OU RÉPUBLIQUE DÉMOCRATIQUE DU CONGO	ZZ
RWANDA OU ZAÏRE	ZZ
RWANDA PRÃFECTURE DE GISENYI	RW
RWANDA UGANDA	ZZ
RWANDA ZAIRE	ZZ
RWANDA ZAÏRE	ZZ
RYSTRÃMMEN NORWAY	NO
RYUKYU IS	JP
RYU KYU ISLANDS	JP
RYUKYU ISLANDS	JP
RYUKYUS	JP
RYUKYU TRENCH	JP
S	ZZ
S A	ZZ
SABA	BQ
SABAH	MY
SABAH MALAYSIA	MY
SABA ISLAND	BQ
S ABYSINIA	ZZ
S ABYSINNIA	ZZ
S ABYSS	ZZ
S ABYSSINIA	ZZ
S ABYSSINIA ERITREA	ER
S ABYSSINIA ETHIOPIA	ET
S ABYSSINICUS	ZZ
S ABYSSMIA	ZZ
SACHLIN I	RU
SACHSEN	DE
SACHSEN-ANHALT	DE
S ADAMANS	IN
SAF	ZZ
SAF NA	ZZ
S AFR	ZA
S AFR BECHUANALAND	BW
S AFRICA	ZA
S AFRICA BOTSWANA	BW
S AFRICA CAPE COLONY	ZA
S AFRICAN REPUBLIC	ZA
S AFRICA SOUTH AFRICA	ZA
S AFRICA TRANSVAAL	ZA
SAGHALIEN	RU
SAGHALIEN I	RU
SAHARA	ZZ
SAHARA ESPAGNOL	EH
SAHARA OCCIDENTAL	EH
SAHARA OF ALGERIA	DZ
SAINT ANDREW ISLAND	ZZ
SAINT ANDREW S ISLAND	ZZ
SAINT BARTHELEMY	BL
SAINT BARTHÉLEMY	BL
SAINT BARTHLÉMY	BL
SAINT CHRISTOPHE ET NEVIS	KN
SAINT CHRISTOPHE ET NIÉVÈS	KN
SAINT CHRISTOPHER	KN
SAINT CHRISTOPHERNEVIS	KN
SAINT CHRISTOPHER NEVIS	KN
SAINT CROIX	ZZ
SAINT CROIX U S VIRGIN ISLANDS	VI
SAINT DOMINGO	DO
SAINT DOMINGUE	DO
SAINT DOMINGUE ET HAITI	ZZ
SAINTE HÉLÈNE ASCENSION ET TRISTAN DA CUNHA	SH
SAINTE HELENE I	SH
SAINTE LUCIE	LC
SAINT EUSTACHE	BQ
SAINT EUSTATIUS	BQ
SAINT HELENA	SH
SAINT HELENA ASCENSION AND TRISTAN DA CUNHA	SH
SAINT HELENA ISLAND	SH
SAINT HELENA SOUTH ATLANTIC OCEAN	SH
SAINT KITTS AND NEVIS	KN
SAINT KITTS ET NEVIS	KN
SAINT KITTSNEVIS	KN
SAINT KITTS NEVIS	KN
SAINT LUCIA	LC
SAINT LUCIA ISLAND	LC
SAINT MAARTEN	SX
SAINT MARIN	SM
SAINT MARTIN	MF
SAINT MARTIN	ZZ
SAINT MARTIN FRANCE	MF
SAINT MARTIN PARTIE FRANÇAISE	MF
SAINT MARTIN PARTIE NÉERLANDAISE	SX
SAINT PAUL ET AMSTERDAM	ZZ
SAINT PAUL I	ZZ
SAINT PAUL ISLAND	ZZ
SAINT PIERRE	PM
SAINT PIERRE AND MIQUELON	PM
SAINT PIERRE ET MIQUELON	PM
SAINT SIÈGE	VA
SAINT SIÈGE ÉTAT DE LA CITÉ DU VATICAN	VA
SAINT THOMAS	VI
SAINT THOMAS U S VIRGIN ISLANDS	VI
SAINT VINCENT	VC
SAINT VINCENT AMP THE GRENADINES	VC
SAINT VINCENT AND THE	VC
SAINT VINCENT AND THE GRENADINES	VC
SAINT VINCENT ET LES GRENADINES	VC
SAINT VINCENTGRENADINES	VC
SAINT VINCENT ISLAND	VC
SAINT VINCENT ST VINCENT AND THE GRENADINES	VC
SAINT VINCENT THE GRENADINES	VC
SAIP	MP
SAIPAN	MP
SAISIE DE DOUANE	ZZ
SAKHALIN	RU
SAKSA (DE)	DE
SAL	SV
SAL	ZZ
SALAWATI I OR N W NEW GUINEA	ID
SALA Y GOMEZ ISLAND	CL
S ALBANIA	AL
S ALGERIA	DZ
S ALGERIA MOROCCO	ZZ
SALISBURY ENGLAND	GB
SALOMON	SB
SALOMON I	SB
SALOMON ÎLES	SB
SALOMON ISLANDS	SB
SALOMON SEA	ZZ
SALTON SEA CALIFORNIA USA	US
SALU IS	ZZ
SALVADOR	ZZ
SALWATTI	ID
SALWATTI I	ID
SALWATTY I	ID
SAM	ZZ
SAMAR IS	PH
SAMARKAND	UZ
SAMBYU KAVANGO NAMIBIA	NA
SAM DOMINGO	DO
S AMERICA	ZZ
S AMERICA ARGENTINA	AR
S AMERICA BRAZIL	BR
S AMERICA CHILE	CL
S AMERICA GRENADA	GD
S AMERICA OR W INDIES	ZZ
S AMERICA URUGUAY	UY
SAMOA	WS
SAMOA AMÉRICAINES	AS
SAMOA AMERICAN	AS
SAMOA AMERICANA	AS
SAMOA GROUP	ZZ
SAMOA I	ZZ
SAMOA INDEPENDENT STATE OF	WS
SAMOA IS	ZZ
SAMOA ISLANDS	ZZ
SAMOA ISLAND S	ZZ
SAMOAN GROUP	ZZ
SAMOAN ISLANDS	ZZ
SAMOA OR KIRIBATI	ZZ
SAMOAS	ZZ
SAMOA SOUTH PACIFIC OCEAN	ZZ
SAMUGAWA BEACH JAPAN	JP
SAMX	ZZ
SÃNÃGAL	SN
SÃNÃGAL FULANI	SN
SÃNÃGAL OUOLOF	SN
SÃNÃGAL PEUPLE PEUL DE LA RÃGION DU SINE SALUM	SN
SÃNÃGAL RÃGION DE THIES PEUPLE DES SÃRÃRES SAFÃN	SN
SÃNÃGAL RÃGION ENTRE LES VILLES KÃDOUGOU ET YUKUNKUN	SN
SÃNÃGAL TOUTE LA ZONE Ã PARTIR DU NORD SÃNÃGAL	SN
SAN AMBROSIO ISLAND	CL
SAN ANDRES	ZZ
SAN ANDRES AND PROVIDENCIA	CO
SAN CRISTÓBAL Y NIEVES	KN
SANDALWOOD I OR SUMBA IS	ID
SANDALWOOD IS OR SUMBA IS	ID
SANDALWOOD IS OR SUMBAWA IS	ID
SANDALWOOD OR SUMBA IS	ID
S ANDAMAN	IN
S ANDAMAN I	IN
S ANDAMAN IS	IN
S ANDAMANS	IN
S ANDAMANS I	IN
S ANDAMANS IS	IN
SAND ISLAND	ZZ
SANDNESSUNDET NORWAY	NO
SAN DOMINGO	DO
SAN DOMINGO I	ZZ
SANDWICH DU SUD I	GS
SANDWICH I	US
SANDWICH I	ZZ
SANDWICH IS	US
SANDWICH IS	ZZ
SANDWICH ISLAND	ZZ
SANDWICH ISLANDS	GS
SANDY HOOK I	US
SAN ENRIQUE NEGROS OCC PHILIPPINES	PH
SAN FABIAN ISABELA PHILIPPINES	PH
SAN FELIX ISLAND	CL
SAN FREDERIGO TUSCANY ITALY	IT
SANGAMON ILLINOIS UNITED STATES	US
SANGI I	ID
SANGI IS	ID
SANGIR IS	ID
S ANGOLA	AO
SAN JOSÉ	ZZ
SAN JOSE COSTA RICA	CR
SAN MARINO	SM
S ANNAM	VN
S ANNAM	ZZ
SAN PEDRO	ZZ
SAN PEDRO Y MIQUELÓN	PM
SAN SALVADOR	ZZ
SAN SALVADOR ISLAND	ZZ
SANSIBAR	TZ
SANS ORIGINE	ZZ
SANTA CAROLINA	US
SANTA CLARA CUBA	CU
SANTA CRUZ IS	ZZ
SANTA CRUZ ISL	ZZ
SANTA CRUZ ISLANDS	ZZ
SANTA DOMINGO	DO
SANTA HELENA	SH
SANTA LUCIA	LC
SANTA LUCÍA	LC
SANTA LUCIA ST LUCIA	LC
SANTA LUCIA WEST INDIES	LC
SAN THOMÉ	ST
SAN THOME I	ST
SAN THOMÉ I	ST
SAN THOMÉ I ANGOLARES GULF OF GUINEA	ST
SAN THOMÉ I GULF OF GUINEA	ST
SAN THOMÉ I ROCA LAURA GULF OF GUINEA	ST
SAN THOMÉ IS	ST
SANTIAGO DE CUBA	CU
SANTO DOMINGO	DO
SANTO DOMINGO D WEST INDIES	DO
SANTO DOMINGO R D	DO
SANTO DOMINGO W I	DO
SAN TOMÉ	ST
SAN TOME IS	ST
SAN TOMÉ IS	ST
SAN TOMÈ IS	ST
SANTO TOMÉ Y PRÍNCIPE	ST
SAN VICENTE Y	VC
SAO THOMÉ	ST
SAO TOME	ST
SÃO TOMÉ	ST
SAOTOMEANDPRINCIPE	ST
SAO TOME AND PRINCIPE	ST
SAO TOME AND PRÍNCIPE	ST
SAO TOMÉ AND PRÍNCIPE	ST
SÃO TOMÉ AND PRÍNCIPE	ST
SÃO TOMÉ E PRÍNCIPE	ST
SAO TOMÉ ET PRINCIPE	ST
SÃO TOMÉ ET PRINCIPE	ST
SAO TOME I	ST
SAO TOME PRINCIPE	ST
SÃO TOMÉ PRINCIPE	ST
SÃO TOMÉ PRÍNCIPE	ST
SAO TOME PRN	ST
SAO TOM� & PRINCIPE	ST
SAPELO ISLAND GEORGIA USA	US
S ARABIA	SA
SARAWAK	MY
SARAWAK MALAYSIA	MY
SARDEGNA	IT
SARDENIA	IT
SARDINIA	IT
SARDINIA ITALY	IT
SAREN I	ZZ
SARGASSO SEA	ZZ
S ARGENTINA	AR
SARU I	JP
SASKATCHEWAN SASKATOON CANADA	CA
S A SOUTH AUSTRALIA	AU
S ATLANTIC	ZZ
S ATLANTIC OCEAN	ZZ
SATONDA I	ID
SAU	SA
SAUDIA ARABIA	SA
SAUDI ARAB	SA
SAUDIARABIA	SA
SAUDI ARABIA	SA
SAUDI ARABIA ARABIA	SA
SAUDI ARABIA YEMEN	ZZ
SAUDI ARABIA YEMEN OMAN	ZZ
SAUDI ARABIA YEMEN OMAN QUATAR UNITED ARAB EMIRATES KUWAIT	ZZ
SAUMUR MAINE ET LOIRE FRANCE	FR
S AUST	AU
S AUSTRALIA	AU
SAVAGE I NIUE I	NU
SAVAGE ISLANDS	PT
SAVANNAH NEAR PANAMA	PA
SAVANNAH OF D GUIANA SURINAM	SR
SAVII I	ID
SAVU I	ID
SAVU IS	ID
SAYCHELLES IS	SC
S BOLIVIA	BO
S BORNEO	ID
S BORNEO	ZZ
S BRAZIL	BR
S BRIT N GUINEA	PG
S BR NEW GUINEA	PG
S BROTHER I	ZZ
S CAMEROON	CM
S CAMEROONS	CM
S CAMEROON S	CM
S CAMEROUN	CM
SCANDINAVIA	ZZ
SCANDINAVIE	ZZ
S C AUSTRALIA	AU
S C D NEW GUINEA	ID
S C DUTCH NEW GUINEA	ID
S CELEBES	ID
S CELEBES I	ID
S CELEBES IS	ID
S CENT D NEW GUINEA	ID
S CENT MADAGASCAR	MG
S CENTRAL CELEBES	ID
S CENTRAL DU NEW GUINEA	ID
S CENTRAL MADAGASCAR	MG
S CENTR DU NEW GUINEA	ID
S CENTR NEW GUINEA	ZZ
S CEYLON	LK
S CHILE	CL
S CHILI	CL
S CHINA	CN
S CHINA INDO CHINA	ZZ
S CHINA SEA	ZZ
SCHOONAARDE BELGIUM	BE
SCHWEIS	CH
SCHWEIZ	CH
SCHWEIZ SWITZERLAND	CH
SCILLY ISLANDS	GB
SC KENYA	KE
S C MOROCCO	MA
S COAST OF NEW GUINEA	ZZ
S COLOMBIA	CO
S COLUMBIA	CO
S COMORO IS CAPE COLONY	ZZ
S CONGO	ZZ
S COREA	KR
SCOT	GB
SCOTIA SEA	ZZ
SCOT IREL ENG	GB
SCOTL	GB
SCOTLAND	GB
SCOTLAND BRITISH ISLES	GB
SCOTLAND GREAT BRITAIN	GB
SCOTLAND OR IRELAND	ZZ
SCOTLAND UK	GB
SCOTLAND U K	GB
SCOTLAND U K ATLANTIC OCEAN	GB
SCOTLAND UK ATLANTIC OCEAN	GB
SCOTLAND U K SCOTCH	GB
SCOTLAND UK SCOTCH	GB
SCOTLAND U K SCOTCH BAVARIA	GB
SCOTLAND, UNITED KINGDOM	GB
SCOTLAND WEST COAST	GB
S DALMATIA	HR
S DENMARK	DK
SDN	SD
S D NEW GUINEA	ID
S DOMINGO	DO
S DUTCH NEW GUINEA	ID
S E ABYSSINIA	ZZ
S E AFRICA	ZZ
S E ALGERIA	DZ
SEA OF JAPAN	ZZ
SEA OF JAPAN FAR EAST OF RUSSIA	RU
SEA OF OKHOTSK	ZZ
S E ASIA	ZZ
SE ASIA	ZZ
SE ASIA MELANESIA	ZZ
SEAS OF NEW ZEALAND	NZ
S EAST CELEBES	ID
S EAST I	ZZ
S EAST IS	ZZ
S EAST ISLES	ZZ
SEATTLE USA	US
S E AUSTRALIA	AU
S E AUSTRIA	AT
S E BAFFINLAND	CA
S E BEAR IS	ZZ
S E BECHUANALAND	BW
S E BELGIAN CONGO	CD
S E BRAZIL	BR
S E BRIT NEW GUINEA	PG
S E BRIT N GUINEA	PG
S E BR NEW GUINEA	PG
S E BULGARIA	BG
S E CELEBES	ID
SE CELEBES	ID
S E CEYLON	LK
S E CHINA	CN
S E COAST MADAGASCAR	MG
S E COAST OF CEYLON IS	LK
S E COAST OF W AUSTRALIA	AU
S E COAST W AUSTRALIA	AU
S E COAST WEST AUSTRALIA	AU
S E COL	CO
S E COLOMBIA	CO
S E CONGO	ZZ
S ECUADOR	EC
S E D NEW GUINEA	ID
S E DUTCH NEW GUINEA	ID
SEEBURG GERMANY	DE
SEE CARD	ZZ
SEE COMMENTS	ZZ
SEE COMMENTS UNITED STATES	US
S E EGYPT	EG
S E ENG	GB
SEE NOTES	ZZ
S E ERITREA	ER
S EEST IS	ZZ
S E ETHIOPIA	ET
SE ETHIOPIA	ET
S E FRANCE	FR
S E GERMANY	DE
S E GUINEA	PG
S EGYPT	EG
S E HAITI	HT
S EHTIOPIA	ET
SE ICELAND	IS
S E INDIA	IN
S E INDIA BURMA	ZZ
SEINE MARITIME FRANCE	FR
S E IRELAND	IE
S E IS	ZZ
S E ISLES	ZZ
S E KOREA	KR
SELANGOR	MY
SELAYER I	ID
SELTA AREA EGYPT	EG
SELVAGENS	PT
S E MADAGASCAR	MG
S E MOROCCO	MA
SEN	SN
SENAGAL	SN
S END OF OKINAWA SHIMA	JP
SENEGAL	SN
SÉNÉGAL	SN
SENEGAL CASAMANCE	SN
SENEGAL COLONY	SN
SENEGAL E	SN
SÉNÉGAL ET NIGER	ZZ
SENEGAL GAMBIA	ZZ
SENEGAL MALI	ZZ
SENEGAL N	SN
SÉNÉGAL NIGER	ZZ
SENEGAL N W AFRICA	SN
SENEGAL OR GUINEA	ZZ
SÉNÉGAL ORIENTAL	SN
SÉNÉGAL OU CÔTE D IVOIRE PROBABLEMENT	ZZ
SÉNÉGAL OU MAURITANIE	ZZ
SÉNÉGAL POSSIBLE	SN
SENEGAMBIA	ZZ
S E NEW GUINEA	PG
S E NEW GUINEA	ZZ
S E NEW IRELAND	PG
S E N G	PG
SENGAL	SN
S ENGLAND	GB
S E N GUINEA	PG
SE N GUINEA	PG
SE N GUINEA	ZZ
SENSIN BELGIUM	BE
S E OF AUSTRALIA	AU
S E OF BRITISH NEW GUINEA	PG
S E OF BRIT NEW GUINEA	PG
S E OF BR NEW GUINEA	PG
S E OF CELEBES	ID
S E OF CELEBES I	ID
S E OF CELEBES IS	ID
S E OF DU NEW GUINEA	ID
S E OF GUINEA	PG
S E OF JAMAICA	JM
S E OF NEW GUINEA	PG
S E OF NEW GUINEA LOUISIADE ARCHIP	PG
S E OF NEW IRELAND	PG
S E OF N GUINEA	PG
S E OF SOUTH AUSTRALIA	AU
S E PAPUA	PG
S E PAPUA NEW GUINEA	PG
S E PERSIA	ZZ
S E PERU	PE
SE QUEENSLAND AUSTRALIA	AU
SERBIA	RS
SERBIA AND MONTENEGRO	ZZ
SERBIA MONTENEGRO	ZZ
SERBIE	RS
SERDANG MALAYSIA	MY
SERDINIA	IT
S ERITREA	ER
SERMATTA I	ID
SERMATTA IS	ID
S ERN ABYS	ZZ
S ERN ABYSSINIA	ZZ
S ERN ETHIOPIA	ET
S ERN MEX	MX
S ERN NIGERIA	NG
SERRANA BANK	CO
S E RUMANIA	RO
S E RUSSIA	RU
SERVIA	RS
S E SIAM	TH
SE SIAM	TH
S E SIBERIA	RU
S E SIERRA LEONE	SL
S E SIERRE LEONE	SL
S E SUMATRA	ID
S E SWEDEN	SE
S E TANGANYIKA	TZ
SE THAILAND	TH
S ETHIOPIA	ET
S E TIBET	CN
S E TUNIS	TN
S E TURKESTAN	ZZ
SETURKEY	TR
SE UNITED STATES	US
S EUROPE	ZZ
SEVEN IS	ZZ
SEY	SC
SEYCHELLAS	SC
SEYCHELLE I	SC
SEYCHELLE IDS	SC
SEYCHELLE IS	SC
SEYCHELLE ISLANDS	SC
SEYCHELLES	SC
SEYCHELLE S	SC
SEYCHELLES COMORROS	ZZ
SEYCHELLES I	SC
SEYCHELLES INDIAN OCEAN	SC
SEYCHELLES IS	SC
SEYCHELLES ISLANDS	SC
SEYCHELLES ISLES	SC
SEYCHELLES ISLS	SC
SEYCHELLES REPUBLIC	SC
SEYCHELLES WEST INDIAN OCEAN	SC
SEYCHELLES W INDIAN OCEAN	SC
S FLORES	ZZ
S FLORES I	ZZ
S FLORES I LESSER SUNDA IS	ID
S FLORES IS	ZZ
S FLOREST I	ZZ
S FORMOSA	TW
S FRANCE	FR
S FRANCE OR SWITZERLAND	ZZ
S GEORGIA	GS
S GEORGIA I	GS
S GEORGIA IS	GS
S GEORGIA ISLE	GS
S GERMANY	DE
SGP	SG
S GREENLAND	GL
SGS	GS
SHAANXI NORTHWESTERN CHINA	CN
S HALIEN	ZZ
SHANGHAI CHINA	CN
S HEBRIDES	GB
SHELIKOF STRAIT	US
SHETLAND DU SUD I	AQ
SHETLAND IS	GB
SHETLAND ISLAND	GB
SHETLAND ISLANDS	GB
SHETLAND ISLES	GB
SHETLANDS	GB
SHIMOGAMO KYOTO JAPAN	JP
SHINFIELD UK	GB
SHINYANGA	TZ
SHITURU CONGO	CD
SHIZUOKA PREFECTURE JAPAN	JP
SHN	SH
SHORTLAND IDS	SB
SHORTLAND IS	SB
SHOWA STATION ANTARCTICA	AQ
SHRILANKA	LK
SHUMAGIN IS	US
S HUNGARY	HU
SIAM	TH
SIAMESE MALAYA	TH
SIAMESE MALAY PEN	TH
SIAMESE MALAY PENINSULA	TH
SIAMESE PENINS	TH
SIAM MALAY PENINSULA	TH
SIAM N	TH
SIAM PEN	TH
SIAM SE	TH
SIAM THAILAND	TH
SIANGI IS	ID
SIB	RU
SIBERIA	RU
SIBÉRIA	RU
SIBERIA ARCTIC AMR TO MEX	ZZ
SIBERIA RUSSIA	RU
SIBUTU I	PH
S ICELAND	IS
SICHUAN SHENG	CN
SICILE I	IT
SICILIA	IT
SICILY	IT
SICILY I	IT
SICILY ITALY	IT
SIERRA DE HUAUTLA MEXICO	MX
SIERRA DE PERU	PE
SIERRA LEON	SL
SIERRA LEONA	SL
SIERRALEONE	SL
SIERRA LEONE	SL
SIERRA LÉONE	SL
SIERRA LEONE PENIN	SL
SIERRA LEONE PENINSULA	SL
SIERRA LEONE RÃGION DE LA KARINA	SL
SIERRA LEONES	SL
SIERRE LEONE	SL
SIKKIM	IN
SILESIA	ZZ
S ILLEG CAMEROON	CM
SIMBABWE REPUBLIK	ZW
SIMBAWA IS	ID
SIMILAN ISLANDS	TH
SIN	SG
SINAI	EG
SINAI PENINS	EG
SINAI PENINSULA	EG
S INDIA	IN
S INDIA MALAY	ZZ
S INDIAN OCEAN	ZZ
SING	SG
SINGAPORE	SG
SINGAPORE I	SG
SINGAPORE MALAYA	SG
SINGAPORE MALAYA	SN
SINGAPORE OR THAILAND	ZZ
SINGAPORE THAILAND	ZZ
SINGAPOUR	SG
SINGAPUR	SG
SINGAPURA	SG
SINGI IS	ID
SING OR HONG KONG	ZZ
SINT EUSTATIUS	BQ
SINT MAARTEN	SX
SIOBAN	ZZ
SI OBAN I	ZZ
SIREUIL CHARENTES FRANCE	FR
SIRHASSEN I	ID
SIRHASSEN IS	ID
SIRIA	SY
S ITALY	IT
SITONDA I	ID
SIVASH LAKE CRIMEA UKRAINE	UA
S JAPAN	JP
S JAVA	ID
S JAVA I	ID
S JAVA IS	ID
SJM	SJ
S KAMEROON	CM
S KAMERUN	CM
SKÃVDE SWEDEN	SE
S KAZAKHSTAN	KZ
S KHARTUM	SD
SKIPPED	ZZ
SKOCJAUSKE JAME	SI
S KOREA	KR
SKOVDE SWEDEN	SE
S KURDESTAN	ZZ
SLAGELSE DENMARK	DK
SLAVONIA	HR
SLB	SB
SLE	SL
S LEONE	SL
S LOO CHOO	JP
S LOO CHOO IS	JP
SLOVACIA	SK
SLOVAKIA	SK
SLOVAK REPUBLIC	SK
SLOVAQUIE	SK
SLOVENIA	SI
SLOVENIA YUGOSLAVIA	SI
SLOVÉNIE	SI
SLOVENSKO	SK
SLV	SV
S MADAGASCAR	MG
S MADEIRA I	PT
S MANCHURIA	CN
S MANTCHURIA	CN
S MAROCCO	MA
S MARQUESA IS	PF
S MEDITERRANEAN BASIN TO E ASIA	ZZ
S MEXICO	MX
S MIGUEL I	ZZ
S MINDANAO	PH
S MOLUCCAS	ID
S MOLUCCA S	ID
S MOLUCCAS INDONESIA	ID
S MONGOLIA	MN
S MOROCCO	MA
S MORROCCO	MA
SMR	SM
SNAKE RIVER WASHINGTON STATE USA	US
SNARES IS	NZ
SNARES ISLAND	NZ
S NATUNA IS	ID
SNELLEGEM BELGIUM	BE
S NEW GUINEA	ZZ
S NEW ZEALAND	NZ
S NIGER	NE
S NIGERA	NG
S NIGERIA	NG
S NORWAY	NO
SOA	ZA
SO ABYSSINIA	ZZ
SO AFRICA	ZA
SOA I	GB
SO ALGERIA	DZ
SOAM	ZZ
SO AMERICA	ZZ
SO BRAZIL	BR
SO CAMEROONS	CM
S O CELEBES	ID
SO CENT DUTCH NEW GUINEA	ID
SO CENTR DU NEW GUINEA	ID
SO CEYLON	LK
SOCI	PF
SOCIALIST REPUBLIC OF VIETNAM	VN
SOCIETIES	PF
SOCIETY GR	PF
SOCIETY I	PF
SOCIETY I OR FIJI	ZZ
SOCIETY IS	PF
SOCIETY ISL	PF
SOCIETY ISLAND	PF
SOCIETY ISLANDS	PF
SOCIETY ISLANDS FRENCH POLYNESIA	PF
SOCOTRA	YE
SOCOTRA I	YE
SOCOTRA IS	YE
SOCOTRA ISLAND	YE
SO DALMATIA	HR
SO EAST CELEBES	ID
SO E CELEBES	ID
SOEDAN	SD
SO ETHIOPIA	ET
S OF AUSTRALIA	AU
S OF BURU	ID
S OF CELEBES	ID
S OF CERAM LAUT IS	ID
S OF CHINA	CN
S OF D NEW GUINEA	ID
S OF ENGLAND	GB
S OF FIGI IS	FJ
S OF FLORES I	ZZ
S OF GERMANY	DE
S OF GOROM I	ID
S OF GOROM IS	ID
SOFIA BULGARIA	BG
S OF INDIA	IN
S OF JAPAN	JP
S OF JAVA	ID
S OF KOREA	KR
S OF MADAGASCAR	MG
S OF MALAY PEN	ZZ
S OF MOROCCO	MA
S OF NEW GUINEA	ZZ
S OF NEW ZEALAND	NZ
S OF N GUINEA	ZZ
S OF N Z	NZ
S OF SUMATRA	ID
S OF SUMBA	ID
S OF W AFRICA	ZZ
SOG	ZZ
SOI	ZZ
SO INDIA	IN
SO IRELAND	IE
SOISSONS AISNE FRANCE	FR
SOIT DE NOUVELLE GUINÉE SOIT DE TERNATE OU SOIT DES CÉLÈBES	ZZ
SOKOTIA I	YE
SOKOTRA I	YE
SOL	SB
SOLO	SB
SOLOMAN ISLANDS	SB
SOLOMEN IS	SB
SOLOMON	SB
SOLOMON I	SB
SOLOMON ID	SB
SOLOMON IDS	SB
SOLOMON IS	SB
SOLOMON ISL	SB
SOLOMON ISLANDS	SB
SOLOMON ISLAND S	SB
SOLOMON ISLANDS NEW GEORGIA GROUP	SB
SOLOMON ISLANDS OR VANUATU OR NEW CALEDONIA	ZZ
SOLOMON ISLANDS PAPUA NEW GUINEA	ZZ
SOLOMON ISS	SB
SOLOMONS	SB
SOLOMON S	SB
SOLOMON S I	SB
SOLOMONS NEW CALEDONIA	ZZ
SOM	SO
SOMALI	SO
SOMALIA	SO
SOMALIA ETHIOPIA	ZZ
SOMALIA FRENCH SOMALILAND	SO
SOMALIA FT	SO
SOMALIA KENYA	ZZ
SOMALIE	SO
SOMALIE OU ETHIOPIE	ZZ
SOMALILAND	SO
SOMALILAND BRITISH	SO
SOMALILAND SOMALIA	SO
SOMALI REPUBLIC	SO
SOMALI WEST AFRICA	SO
SOMBRERO ISLAND	AI
SOMEREN THE NETHERLANDS	NL
SOMEWHERE IN AFRICA	ZZ
SO MEXICO	MX
SOMILILAND	SO
SOMLILAND	SO
SO MOROCCO	MA
SO NEW GUINEA	ZZ
SO NIGERIA	NG
SO PALESTINE	PS
SO PERU	PE
SO RHODESIA	ZW
S ORKNEY IS	AQ
SOROTI	UG
SORSOGON SORSOGON PHILIPPINES	PH
SO RUSSIA	RU
SO RUSSIAN ALTAI	RU
SO RYUKYUS	JP
SO SIBERIA	RU
SO SPAIN	ES
SO TRINIDAD	TT
SO TUNIS	TN
SOUDAN	SD
SOUDAN DU SUD	SS
SOUDAN EST	SD
SOUDAN ET SOUDAN FULANI	SD
SOUDAN FRANÇAIS	ML
SOUDAN FULANI	SD
SOUDAN KORDOFAN	SD
SOUDAN RÃGION DE LEST	SD
SOUDAN SUDAN	SD
SOUSS MOROCCO	MA
SOUTH AFICA	ZA
SOUTHAFRICA	ZA
SOUTH AFRICA	ZA
SOUTH AFRICA KENYA	ZZ
SOUTH AFRICAN	ZA
SOUTH AFRICAN SEAS	ZA
SOUTH AFRICA OR AUSTRALIA	ZZ
SOUTH AFRICA OR NATAL	ZA
SOUTH AFRICA SUID AFRIKA	ZA
SOUTH AFRICA SWAZILAND	ZA
SOUTH AFRICA SWAZILAND	ZZ
SOUTH AFRICA W O	ZA
SOUTH AFRICA ZIMBABWE	ZZ
SOUTH AFRICA ZULULAND	ZA
SOUTH AFRIKA	ZA
SOUTH AMERICA	ZZ
SOUTH AMERICA ARGENTINA	AR
SOUTH AMERICA BY INFERENCE	ZZ
SOUTH AMERICAN CHILE	CL
SOUTH AMERICA PARAGUAY	PY
SOUTH ANDAMAN IS	IN
SOUTH ANNAM	ZZ
SOUTH ARABIA	ZZ
SOUTH ARFICA	ZA
SOUTH ASIA	ZZ
SOUTH ATLANTIC	ZZ
SOUTH ATLANTIC COAST	ZZ
SOUTH ATLANTIC OCEAN	ZZ
SOUTH AUSTRALIA	AU
SOUTH BAHAMAS	BS
SOUTH BIMINI	BS
SOUTH BOLIVIA	BO
SOUTH BRAZIL	BR
SOUTH CAICOS	TC
SOUTH CAMEROON	CM
SOUTH CAROLINA	US
SOUTH CAROLINA UNITED STATES	US
SOUTH CAROLINA USA	US
SOUTH CELEBES	ID
SOUTH CENTRAL DUTCH NEW GUINEA	ID
SOUTH CEYLON	LK
SOUTH CHILE	CL
SOUTHCHINA	CN
SOUTH CHINA	CN
SOUTH CHINA AND EASTERN ARCHIPELAGIC SEAS	ZZ
SOUTH CHINA SEA	ZZ
SOUTH CHINA SEA CHINA	CN
SOUTH COAST OF AUSTRALIA	AU
SOUTH COAST OF INDIA	IN
SOUTH COAST OF ST VINCENT B W I	VC
SOUTH COPENHAGEN DENMARK	DK
SOUTH DAKOTA USA	US
SOUTH EAST AFRICA	ZZ
SOUTHEAST AFRICA	ZZ
SOUTH EAST ASIA	ZZ
SOUTHEAST ASIA	ZZ
SOUTHEAST BRAZIL	BR
SOUTH EAST COAST OF MADAGASCAR	MG
SOUTH EASTERN AUSTRALIA	AU
SOUTH EASTERN BRAZIL	BR
SOUTHEASTERN IRAN KIRMAN	IR
SOUTHEASTERN US	US
SOUTH EAST ETHIOPIA	ET
SOUTH EAST I	ZZ
SOUTHEAST IRAN	IR
SOUTH EAST IS	ZZ
SOUTH EAST MADAGASCAR	MG
SOUTHEAST NEW GUINEA	ZZ
SOUTHEAST N GUINEA	PG
SOUTHEAST N GUINEA	ZZ
SOUTH EAST OF ABERDEEN MILES EAST	GB
SOUTH EAST OF NEW GUINEA	PG
SOUTH END OF SAN TOMÈ IS	ST
SOUTH END OF ST VINCENT B W I	VC
SOUTH END SAN THOMÉ	ST
SOUTH END SAN THOMÉ IS	ST
SOUTH END SAN TOMÉ IS	ST
SOUTHERN ABYSSINIA	ZZ
SOUTHERN AFRICA	ZZ
SOUTHERN ARABIA	ZZ
SOUTHERN ASIA	ZZ
SOUTHERN AUSTRALIA	AU
SOUTHERN BOHEMIA	CZ
SOUTHERN BRAZIL	BR
SOUTHERN BULGARIA	BG
SOUTHERN CAMEROON	CM
SOUTHERN CAMEROONS	CM
SOUTHERN CHINA	CN
SOUTHERN COAST OF GREENLAND	GL
SOUTHERN DENMARK	DK
SOUTHERN ENGLAND UK	GB
SOUTHERN ETHIOPA	ET
SOUTHERN ETHIOPIA	ET
SOUTHERN EUROPE	ZZ
SOUTHERN FRANCE	FR
SOUTHERN FRENCH CAMEROON	CM
SOUTHERN INDIA	IN
SOUTHERN IRAN	IR
SOUTHERN ISLAND OF N ZEALAND	NZ
SOUTHERN KENYA	KE
SOUTHERN MALAWI	MW
SOUTHERN MEXICO	MX
SOUTHERN MONGOLIA	MN
SOUTHERN NEW HEBRIDES	VU
SOUTHERN N HEBRIDES	VU
SOUTHERN NIGERIA	NG
SOUTHERN OCEAN	ZZ
SOUTHERN OCEANS	ZZ
SOUTHERN PERU	PE
SOUTHERN RHODESIA	ZW
SOUTHERN RODESIA	ZW
SOUTHERN RUSSIA	RU
SOUTHERN RYUKYUS	JP
SOUTHERN SOMALIA	SO
SOUTHERN SPAIN	ES
SOUTHERN STATES	US
SOUTHERN ST VINCENT B W I	VC
SOUTHERN SYRIA	SY
SOUTHERN THAILAND	TH
SOUTHERN UNITED STATES	US
SOUTHERN URAL RUSSIA	RU
SOUTHERN URUGUAY	UY
SOUTHERN US	US
SOUTHERN UZBEKISTAN	UZ
SOUTH ESSEX UK	GB
SOUTH ETHIOPIA	ET
SOUTH EUROPE	ZZ
SOUTH FLORES	ZZ
SOUTH FORMOSA	TW
SOUTHFRANCE	FR
SOUTH FRANCE	FR
SOUTH GEORGE I	GS
SOUTH GEORGIA	GS
SOUTH GEORGIA AND SANDWICH ISLANDS	GS
SOUTH GEORGIA AND SOUTH SANDWICH ISLANDS	GS
SOUTH GEORGIA AND THE SOUTH SANDWICH ISLANDS	GS
SOUTH GEORGIA I	GS
SOUTH GEORGIA IS	GS
SOUTH GEORGIA ISLAND	GS
SOUTH GEORGIA SOUTH SANDWICH ISLANDS	GS
SOUTH GEORGIA UK	GS
SOUTH GERM NEW GUINEA	PG
SOUTH GREENLAND	GL
SOUTH HIGHLANDS	ZZ
SOUTH ICELAND	IS
SOUTH INDIA	IN
SOUTH INDIA COAST	IN
SOUTH INDIAN OCEAN	ZZ
SOUTH INDIAN OR ATLANTIC OCEAN	ZZ
SOUTH IRAN	IR
SOUTHITALY	IT
SOUTH ITALY	IT
SOUTH JAPAN	JP
SOUTH KAOLACK SENEGAL	SN
SOUTH KOREA	KR
SOUTH LEBANON	LB
SOUTH LOO CHOO IS	JP
SOUTH MADAGASCAR	MG
SOUTH MEXICO	MX
SOUTH MOLUCCAS	ID
SOUTH NEW GUINEA	ZZ
SOUTH NIGERIA	NG
SOUTH NORTHWEST AUSTRALIA	AU
SOUTH NORWAY	NO
SOUTH OF AUSTRALIA	AU
SOUTH OF BONIN IS	JP
SOUTH OF BURMA	MM
SOUTH OF CELEBES	ID
SOUTH OF ENGLAND	GB
SOUTH OF FRANCE	FR
SOUTH OF ICELAND	IS
SOUTH OF IRELAND	IE
SOUTH OF MADEIRA I	PT
SOUTH OF NEW GUINEA	ZZ
SOUTH OF NEW ZEALAND	NZ
SOUTH OF N ZEALAND	NZ
SOUTH ORKNEY IS	AQ
SOUTH ORKNEY ISLANDS	AQ
SOUTH ORKNEY ISLANDS UK	AQ
SOUTH ORKNEYS	AQ
SOUTH OSSETIA	GE
SOUTH PACIFIC	ZZ
SOUTH PACIFIC OCEAN	ZZ
SOUTH PACIFIC OCEAN AND PAPUA NEW GUINEA	ZZ
SOUTH PACIFIC OCEAN OR PAPUA NEW GUINEA	ZZ
SOUTH PACIFIC PROBABLY	ZZ
SOUTH PERU	PE
SOUTH PORTUGAL	PT
SOUTH RHODESIA	ZW
SOUTH RUSSIA	RU
SOUTH SANDWICH ISLANDS	GS
SOUTH SEA I S	ZZ
SOUTH SEA ISLANDS	ZZ
SOUTH SEAS	ZZ
SOUTH SEAS ISLANDS	ZZ
SOUTH SHETLAND	AQ
SOUTH SHETLAND I	AQ
SOUTH SHETLAND IS	AQ
SOUTH SHETLAND ISLANDS	AQ
SOUTH SHETLANDS	AQ
SOUTH SPAIN	ES
SOUTH SUDAN	SS
SOUTH SWEDEN	SE
SOUTH THAILAND MALAYSIA PENINSULA	TH
SOUTH UZBEKISTAN	UZ
SOUTH VIETNAM	VN
SOUTH W AFRICA	NA
SOUTH WALES	GB
SOUTH WEST	ZZ
SOUTH WEST AFRICA	NA
SOUTH WEST AFRICA	ZZ
SOUTHWEST AFRICA	NA
SOUTHWEST AFRICA	ZZ
SOUTH WEST AFRICA NAMBIA	NA
SOUTH WEST AFRICA NAMIBIA	NA
SOUTHWEST AFRICA PROTECTORATE	NA
SOUTH WEST ANGOLA	AO
SOUTH WEST AUSTRALIA	AU
SOUTHWEST AUSTRALIA	AU
SOUTH WESTERN ICELAND	IS
SOUTHWESTERN SOUTH AMERICA	ZZ
SOUTHWESTERN US	US
SOUTHWESTERN USA	US
SOUTH WEST GREENLAND	GL
SOUTH WEST I	ZZ
SOUTH WEST ICELAND	IS
SOUTHWEST INDIA	IN
SOUTHWEST IRAN	IR
SOUTH WEST IRELAND	IE
SOUTH WEST IS	ZZ
SOUTH WEST I S	ZZ
SOUTHWEST IS	ZZ
SOUTH WEST JAPAN	JP
SOUTH WEST MADAGASCAR	MG
SOUTH WEST OF ICELAND ATLANTIC OCEAN	IS
SOUTH WEST OF IRELAND ATLANTIC OCEAN	IE
SOUTH WEST OF U K ATLANTIC OCEAN	GB
SOUTH WEST UGANDA	UG
SOUTHWEST US	US
SOUTH W IS	ZZ
SOUTH YEMEN	YE
SOVIET CENTRAL ASIA	ZZ
SOVIET UNION	ZZ
SO WEST IS	ZZ
SPAC	ZZ
S PACIFIC	ZZ
S PACIFIC OCEAN	ZZ
SPAI	ES
SPAIN	ES
SPAIN ESPAÑA	ES
SPAIN ESPAÑA ESPAGNE	ES
SPAIN OR PORTUGAL	ZZ
SPAIN PORTUGAL ANDORRA GIBRALTAR	ZZ
SPAIN, SPANISH STATE	ES
S PALESTINE	PS
SPANIEN	ES
SPANISH	ES
SPANISH GUINEA	GQ
SPANISH GUINEA FERNANDO POO	GQ
SPANISH HONDURAS	HN
SPANISH SAHARA	EH
SPANISH W AFRICA	EH
SPANISH WEST AFRICA	EH
S PERSIA	ZZ
S PERU	PE
SPETSBERGEN	SJ
SP HONDURAS	HN
SPIRIT LAKE WASHINGTON USA	US
SPITSBERGEN	SJ
SPITZBERGEN	SJ
SPITZBERGEN SVALBARD	SJ
SPITZBERG I	SJ
SPM	PM
S PORTUGAL	PT
S PRUSSIA	ZZ
SP W AFRICA	EH
SQUALLY I	PG
SQUALLY OR STORM I	PG
SRB	RS
SR CF	SR
S RHODESIA	ZW
S RHODIESIA	ZW
SRI	LK
SRIL	LK
SRILANKA	LK
SRI LANKA	LK
SRI LANKA CENTRAL	LK
SRI LANKA CEYLAN CEYLON	LK
SRI LANKA CEYLON	LK
SRI LANKA EAST	LK
SRI LANKA NORTH CENTRAL CEYLON	LK
SRI LANKA SRI LANKA	LK
SRODESIA	ZW
S RUMANIA	RO
S RUSSIA	RU
S RUSSIA TURKESTAN	RU
S RUSSIA W CHINA	ZZ
SRV	ZZ
S SANDWICH IS	GS
S SARDENIA	IT
S SCOTLAND	GB
S SCOTLAND U K	GB
SSD	SS
S SERBIA	RS
S SHAN STATES	MM
S SHETLAND IS	AQ
S SHETLANDS	AQ
S SIBERIA	RU
S SOLOMON IS	SB
S SOMALILAND	SO
S SOUTH AUSTRALIA	AU
S SPAIN	ES
SSR	ZZ
S STATES TO S AMERICA	ZZ
S SUMBAWA	ID
S SWEDEN	SE
S SWITZERLAND	CH
STA CRUZ BOLIVIA	BO
ST AIGNAN I	PG
ST AMANDS BELGIUM	BE
ST AMDREW ISLAND	ZZ
ST ANDREWS	ZZ
ST ANDREWS ISLAND	ZZ
ST ANDREWS KEY	ZZ
S TANGANYIKA	TZ
STANISLAUS COUNTY CALIFORNIA USA	US
S TASMANIA	AU
STATE OF KUWAIT	KW
STATE OF PALESTINE	PS
STATES OF MALAYA	MY
ST BARTHELEMY	BL
ST BARTHELEMY ISLAND	BL
ST BARTHELEMY OR ST MARTIN	ZZ
ST BARTHOLEMEW	BL
ST BRANDON SHOAL	MU
ST BRANDON SHOALS	MU
ST BRANDON S SHOAL	MU
ST BRIEUC FRANCE	FR
ST CHRISTOPHER	KN
STCHRISTOPHERNEVIS	KN
ST CHRISTOPHERNEVIS	KN
ST CROIX	ZZ
ST DOMINGO	DO
S TENASSERIM	MM
ST EUSTATIUS	BQ
ST EUSTATIUS ISLAND	BQ
ST EUSTATUS	BQ
STEWART ISLAND	NZ
ST GHISLAINE BELGIUM	BE
S THAILAND	TH
ST HELENA	SH
ST HELENA ASCENSION AND TRISTAN DA CUNHA	SH
ST HELENA I	SH
ST HELENA ISLAND	SH
ST HELENA S ATLANTIC	SH
ST HELENA SOUTH ATLANTIC OCEAN	SH
S THOME	ST
ST JOHN	ZZ
ST KILDA	GB
ST KILDA I	GB
ST KITTS	KN
ST KITTS AMP NEVIS	KN
ST KITTS AND NEVIS	KN
ST KITTS AND NEVIS NEVIS	KN
ST KITTS AND NEVIS ST KITTS	KN
ST KITTS NEV	KN
ST KITTSNEVIS	KN
ST KITTS NEVIS	KN
ST KITTSNEVIS ISLANDS	KN
ST LOUIS USA	US
STLOUIS USA	US
STLUCIA	LC
ST LUCIA	LC
ST LUCIA ISLAND	LC
ST LUCIA WEST INDIES	LC
ST LUCIA WI	LC
ST MARTIN	MF
ST MARTIN	ZZ
ST MARTIN ISLAND	ZZ
ST MARTIN SINT MAARTEN	ZZ
ST MATHIAS I	PG
ST MATTHIAS	PG
ST MATTHIAS I	PG
ST MATTHIAS IS	PG
ST MAURICE FRANCE	FR
ST NARAIRE FRANCE	FR
STOCKHOLM SWEDEN	SE
STO DOMINGI	DO
STO DOMINGO	DO
S TOGOLAND	ZZ
STOKEONTRENT ENGLAND	GB
STOMÉ E PRÍNCIPE	ST
STORM I	PG
STORM OR SQUALLY I	PG
STORRS CONN USA	US
STP	ST
ST PAUL IS	ZZ
ST PAUL ISLAND	ZZ
ST PAUL ISLAND INDIAN OCEAN	TF
ST PAUL ISLE	ZZ
ST PETER AND ST PAUL ROCKS	BR
ST PIER MQ	MQ
ST PIERRE AND MIQUELON	PM
ST PIERRE AND MIQUELON TERRITORIAL COLLECTIVITY OF SAINT PIERRE AND MIQUELON FRANCE	PM
ST PIETERSHOSPITAAL BRUSSEL BELGIUM	BE
STPIETERSVOEREN BELGIUM	BE
STRAIT OF MALACCA	ZZ
STRAIT SETTLEMENTS	ZZ
STRAITS OF MAGELLAN	ZZ
STRAITS OF MALACCA	ZZ
STREMY BELGIUM	BE
S TRINIDAD	TT
S TRINIDAD I	TT
ST THOMAS	VI
ST THOMAS	ZZ
ST THOMAS HOSPITAL LONDON UK	GB
S TUNIS	TN
S TUNISIA	TN
S TURKESTAN	ZZ
STUTTGART GERMANY	DE
STUTTGARTHOHENHEIM GERMANY	DE
ST VERDE IS	ZZ
ST VICENT AMP THE GREN	VC
ST VIN AMP THE GRENADINES	VC
STVINCENT	VC
ST VINCENT	VC
ST VINCENT AMP THE GREN	VC
ST VINCENT AMP THE GRENAD	VC
ST VINCENT AND THE	VC
STVINCENT AND THE	VC
ST VINCENT AND THE GREN	VC
ST VINCENT AND THE GRENADINES	VC
ST VINCENT AND THE GRENADINES ST VINCENT	VC
ST VINCENT B W I	VC
ST VINCENT GRENADINES	VC
ST VINCENT ISLAND	VC
ST VINCENT ISLANDS	VC
ST VINCENT THE GRENADINES	VC
ST VINCENT THE GRENDINES	VC
ST VINCENT WEST INDIES	VC
SUAZILANDIA	SZ
SUBANTARCTIC ISLANDS	ZZ
SUD	ZZ
SUDÁFRICA	ZA
SUD ÀFRICA REPÚBLICA DE	ZA
SUDAN	SD
SUDÁN	SD
SUDAN DEL SUD	SS
SUDAN EGYPT	ZZ
SUDAN N	SD
SUDAN SOUTHERN	SD
SUDAN S W	SD
SUD BOLIVIA	BO
SUDEST I	ZZ
SUDEST IS	ZZ
SUD MADAGASCAR	MG
SÜD W AFRICA	NA
SUECIA	SE
SUÈCIA	SE
SUEDE	SE
SUÈDE	SE
SUÈDE SWEDEN ZWEDEN	SE
SUIÇA	CH
SUÏSSA	CH
SUISSE	CH
SUIZA	CH
SUKAMANDI INDONESIA	ID
SULA BESI	ID
SULA CELEBES IS	ID
SULA I	ID
SULA IS	ID
SULA MANGOLI	ID
SULAWESI	ID
SULAWESI CELEBES	ID
SULAWESI INDONESIA	ID
SULAWESI UTARA	ID
SULTANATE OF OMAN	OM
SULU I	ID
SULU IS	ID
SULU IS E CELEBES	ID
SULU IS JOLO	ID
SULU IS N CELEBES	ID
SULU IS YOLO	ID
SUMATRA	ID
SUMATRA BOCK	ID
SUMATRA DELI	ID
SUMATRA INDONESIA	ID
SUMATRA IS	ID
SUMATRA S W FT	ID
SUMATRA WEST COAST	ID
SUMBA	ID
SUMBAE I	ID
SUMBA I	ID
SUMBA I LESSER SUNDA IS	ID
SUMBA IS	ID
SUMBANA IS	ID
SUMBAWA	ID
SUMBAWA I	ID
SUMBAWA IS	ID
SUMBO	ID
SUNDA IS	ID
SUNDA ISLAND	ID
SUNDA ISLANDS	ID
SUNDAY I	AU
SUNDSVALL SWEDEN	SE
SUNGEI BULOH MALAYSIA	MY
SUOMI	FI
SUOMI (FI)	FI
SUR	SR
SURI	SR
SURINA	SR
SURINAM	SR
SURINAM D GUIANA	SR
SURINAME	SR
SURINAME DUTCH GUIANA	SR
SURINAMEE	SR
SURINAME VENEZUELA	ZZ
SURINAM OFFSHORE	SR
SURINAM PROBABLY	SR
SURINAM VENEZUELA	ZZ
SURINAN	SR
SURREY UK	GB
SURUGA BAY JAPAN	JP
S US TO N SOUTH AMERICA GALAPAGOS	ZZ
SVALBARD	SJ
SVALBARD AMP JAN MAYEN ISLANDS	SJ
SVALBARD AND JAN MAYEN	SJ
SVALBARD AND JAN MAYEN ISLANDS	SJ
SVALBARD ARCHIPELAGO NORWAY	SJ
SVALBARD ET ÎLE JAN MAYEN	SJ
SVALBARD JAN MAYEN ISLANDS	SJ
SVALBARD NORWAY	SJ
SVALBARD Y JAN MAYEN	SJ
SVERIGE	SE
S VICTORIA LAND	AQ
SVK	SK
SVN	SI
S W AFRICA	NA
S W AFRICA	ZZ
SW AFRICA	NA
S WALES	GB
S W ALGERIA	DZ
SWALLOW	ZZ
SWALLOW I	KI
SWANAMIBIA	NA
SWA NAMIBIA	NA
S W ANGOLA	AO
SWAN ISLAND	ZZ
SWAN ISLANDS	ZZ
S W ARABIA	ZZ
S W ARABIA YEMEN	ZZ
S W ARGENTINA	AR
SWARTKOPPIES TRANSVAAL SOUTH AFRICA	ZA
S W AUSTRALIA	AU
SWAZ	SZ
SWAZILAND	SZ
S W B BECHUANALAND	BW
S W BORNEO	ID
S W BORNEO	ZZ
S W BOUNDARY OF UGANDA	UG
SW BRAZIL	BR
S W CELEBES	ID
S W CHILE	CL
S W CHINA	CN
SW CHINA	CN
S W COAST MADAGASCAR	MG
S W COAST NEW IRELAND	PG
S W COAST OF ICELAND	IS
S W COAST OF MADAGASCAR	MG
S W COLOMBIA	CO
S W CORNER BECHUANALAND	BW
SWE	SE
S W ECUADOR	EC
SWEDEN	SE
SWEDEN NORWAY	ZZ
SWEDISH LAPLAND	SE
SWEDISH LAPLAND SWEDEN	SE
SWEDON	SE
S WERT IS	ZZ
S WEST AUSTRALIA	AU
S WEST AUSTRALIA COAST	AU
S WEST I	ZZ
S WEST IS	ZZ
S WEST I S	ZZ
S WEST ISLAND	ZZ
S WEST ISLANDS	ZZ
S WEST ISLES	ZZ
S W EUROPE	ZZ
S W FORMOSA	TW
S W FRANCE	FR
S W GERMANY	DE
S W GREENLAND	GL
S W HAITI	HT
SWI	CH
SW ICELAND	IS
S W INDIA	IN
S W INDIES	ZZ
S W INLAND MADAGASCAR	MG
S W IRELAND	IE
S W IS	ZZ
S W ISLANDS	ZZ
S W ISLES	ZZ
SWITSERLAND	CH
SWITZ	CH
SWITZERLAND	CH
SWITZERLAND SCHWEIZ SUISSE SVIZZERA SVIZRA	CH
SWITZERLAND SUISSE SCHWEIZ SVIZZERA SVIZRA	CH
SWITZERLAND SUISSE ZWITSERLAND	CH
SWITZERLAND SUISSE ZWITSERLAND DIE SCHWEIZ	CH
SWITZLAND	CH
S W KENYA	KE
SW KENYA	KE
S W MADAGASCAR	MG
S W MAROCCO	MA
S W MEXICO	MX
S W MOROCCO	MA
S W NEPAL	NP
S W NEW GUINEA	ZZ
S W NEW IRELAND	PG
S W N GUINEA	ID
S W OF AUSTRALIA	AU
S W OF BOKHARA	UZ
S W OF ENGLAND	GB
S W OF GOROM IS	ID
S W OF NEW GUINEA	ID
S W OF SUMATRA	ID
S W PACIFIC	ZZ
S W PERSIA	ZZ
S W PERU	PE
S W SARDINIA	IT
S W SERBIA	RS
S W SIAM	TH
S W SIBERIA	RU
S W SOUTH AMERICA	ZZ
S W SOUTH AUSTRALIA	AU
S W SUMATRA	ID
S W SWEDEN	SE
SW TRINIDAD	TT
S W TUNIS	TN
S W TURKESTAN	ZZ
S W UGANDA	UG
SW UGANDA	UG
S W U S A	US
S W W AUSTRALIA	AU
SWZ	SZ
SXM	SX
SYC	SC
SYCHELLES IS	SC
SYD SIAM	TH
SYEMEN	YE
SYR	SY
SYRIA	SY
SYRIA LEBANON	ZZ
SYRIANARABREPUBLIC	SY
SYRIAN ARAB REPUBLIC	SY
SYRIAN DESERT	SY
SYRIE	SY
SYRIENNE RÉPUBLIQUE ARABE	SY
TAAF	TF
TAAM I	ID
TAAM IS	ID
TAÃWAN	TW
TABAGO	TT
TABASCO MEXICO	MX
TABOGA	TT
TADJIKISTAN	TJ
TADJIKSTAN	TJ
TADJSSR	TJ
TADZHIK	TJ
TADZHIKISTAN	TJ
TADZHISKISTAN	TJ
TADZIKSTAN	TJ
TAEM IS	ZZ
TAHI	PF
TAHITI	PF
TAHITI ARCH	PF
TAHITI I	PF
TAHITI IS	PF
TAI	TW
TAILANDIA	TH
TAILÀNDIA	TH
TAIPEI	TW
TAIPEI CITY	TW
TAIPEI CO	TW
TAIW	TW
TAIWAN	TW
TAIWÁN	TW
TAÏWAN	TW
TAIWAN FORMOSA	TW
TAIWAN FORMOSE	TW
TAÏWAN PROVINCE DE CHINE	TW
TAIWANPROVINCEOFCHINA	TW
TAIWAN PROVINCE OF CHINA	TW
TAIWAN R O C	TW
TAJIKISTAN	TJ
TALAIA	PT
TALANT IS	ID
TALANT ISLAND	ID
TALAOER IS	ID
TALAUT I	ID
TALAUT IS	ID
TAM	ZZ
TAN	TZ
TANA MERA	ZZ
TANAZANIA	TZ
TANGANGIKA TERR	TZ
TANGANGIKA TERRITORY	TZ
TANGANIKA TERR	TZ
TANGAN TERRITORY	TZ
TANGANYIKA	TZ
TANGANYIKA TANZANIA	TZ
TANGANYIKA TANZANIA AFRICA	TZ
TANGANYIKA TER	TZ
TANGANYIKA TERR	TZ
TANGANYIKA TERRITORY	TZ
TANGANYKA TERR	TZ
TANG TER	TZ
TANG TERR	TZ
TANGUINYIKA	TZ
TANSANIA	TZ
TAN TG	ZZ
TANYKELI	MG
TANZ	TZ
TANZANIA	TZ
TANZÀNIA	TZ
TANZANIA CAPTIVE	TZ
TANZANIA KENYA	ZZ
TANZANIA TANGANYIKA TERRITORY	TZ
TANZANIAUNITEDREPUBLICOF	TZ
TANZANIA UNITED REPUBLIC OF	TZ
TANZANIA ZAMBIA	ZZ
TANZANIE	TZ
TANZANIE ARUSHA KILIMANDJARO	TZ
TANZANIE CHAGGA	TZ
TANZANIE DE LEST	TZ
TANZANIE HAYA	TZ
TANZANIE IWAMBIMBEYA DISTRICT	TZ
TANZANIE MAMBAMOSHI DISTRICT	TZ
TANZANIE MARANGU DISTRICT	TZ
TANZANIE MARANGU MOSHI DISTRICT	TZ
TANZANIE MARANGUMOSHI DISTRICT	TZ
TANZANIE MASAI	TZ
TANZANIEMASAI CHAGGA SUKUMA	TZ
TANZANIE MBARALI DISTRICT	TZ
TANZANIE MBEYA DISTRICT	TZ
TANZANIE MBOZI DISTRICT	TZ
TANZANIE MOSHI DISTRICT	TZ
TANZANIE MOSHI RURAL DISTRICT	TZ
TANZANIE MOSHI SANJA JUUHAI DIST	TZ
TANZANIE MWIKAMOSHI DISTRICT	TZ
TANZANIE PAYS DU SIMANJIRO	TZ
TANZANIE RÉPUBLIQUE UNIE DE	TZ
TANZANIE RUJAWAMBARALI DISTRICT	TZ
TANZANIE RUJEWAMBARALI	TZ
TANZANIE RUJEWAMBARALI DISTRICT	TZ
TANZANIE SAJA JUU MOSHI DISTRICT	TZ
TANZANIE SAMYA JUU HAI DISTRICT	TZ
TANZANIE SANJA JUU DISTRICT	TZ
TANZANIE SANJA JUU HAI DISTRICT	TZ
TANZANIE SANYA JUU DISTRICT	TZ
TANZANIE SANYA JUU HAI DISTRICT	TZ
TANZANIE SENYA JUU HAI DISTRICT	TZ
TANZANIE URUMOSHI DISTRICT	TZ
TANZANIE WEST KILIMANJARO	TZ
TANZNIA	TZ
TAS	AU
TASMANIA	AU
TASMANIA AUSTRALIA	AU
TASMANIE	AU
TASMAN SEA	AU
TAVUNASITHI I	FJ
TAYIKISTÁN	TJ
TCA	TC
TCD	TD
TCHAD	TD
TCHAD PAYS SAR	TD
TCHECOSLOVAQUIE	ZZ
TCHÉCOSLOVAQUIE	ZZ
TCHÈQUE RÉPUBLIQUE	CZ
TELLO IS	ID
TEMASSERIM	MM
TEMIMBER I	ID
TEMOR I	ID
TENASSERIM	MM
TENDE FRANCE	FR
TENDELTI SUDAN	SD
TENERIFE	ES
TENIMBER	ID
TENIMBER I	ID
TENIMBER IS	ID
TENIMBER I S	ID
TENIMBER IS TIMOR LAUT	ID
TENNESSEE UNITED STATES	US
TENNESSEE USA	US
TENOS I	GR
TEOKONG BESI IS	ID
TEOOR I	ID
TEOOR I N OF KEY IS	ID
TEOOR ISL	ID
TEPOTO ATOLL	PF
TERCEIRA I	PT
TERNATE	ID
TERNIMBER IS	ID
TER OF PAPUA	PG
TERRAGONA PROVINCE SPAIN	ES
TERRES AUSTRALES ET ANTARCTIQUES FRANÇAISES	TF
TERRES AUSTRALES FRANÇAISES	TF
TERRITOIRE ANTARCTIQUE BRIT	AQ
TERRITOIRE BRITANNIQUE DE L OCÉAN INDIEN	IO
TERRITOIRE DES TERRES AUSTRALES ET ANTARCTIQUES FRANÇAISES	TF
TERRITOIRE PALESTINIEN OCCUPÉ	PS
TERRITORIO BRITÁNICO DEL OCÉANO	IO
TERRITORIOS AUSTRALES FRANCESES	TF
TERRITORIOS PALESTINOS	PS
TERRITORY OF AMERICAN SAMOA	AS
TERRITORY OF PAPUA	PG
TERRITORY OF THE FRENCH SOUTHERN AND ANTARCTIC LANDS	TF
TERR NEW GUINEA	ZZ
TERR N GUIN	ZZ
TERR N GUINEA	ZZ
TERR N GUIN PAPUA	PG
TERR OF NEW GUINEA	ZZ
TERR OF N GUINEA SOLOMON ISLANDS	SB
TERR OF PAPUA	PG
TERR OF PAPUA N G	PG
TERR OF PAPUS	PG
TERR PAPUA	PG
TEVOR IS	MY
TEXAS	US
TEXAS USA	US
TGO	TG
THA	TH
THAÃLAND	TH
THAI	TH
THAILAND
THAILAND	TH
THAILAND CENTRAL	TH
THAILANDE	TH
THAÏLANDE	TH
THAÏLANDE OU CAMBODGE	ZZ
THAILAND FRENCH INDO CHINA	TH
THAILAND LAOS	ZZ
THAILAND MALAYSIA	ZZ
THAILAND NE	TH
THAILAND OR MALAYSIA	ZZ
THAILAND PROB	TH
THAILAND PROBABLY	TH
THAILAND SIAM	TH
THAILLAND	TH
THALIAND	TH
THE BAHAMAS	BS
THE CANARY ISLANDS	ES
THE CONGO	ZZ
THE DUTCH WEST INDIES	ZZ
THE FORMER YUGOSLAV REPUBLIC OF MACEDONIA	MK
THE GAMBIA	GM
THE GAMBIA SENEGAL	ZZ
THE GREAT PETER GULF THE SEA OF JAPAN RUSSIA	RU
THE NETHERLANDS	NL
THE NETHERLANDS ANTILLES	ZZ
THE NETHERLANDS (HOLLAND)	NL
THE PHILIPPINE ISLANDS	PH
THE PHILIPPINES	PH
THE SNARES NEW ZEALAND	NZ
THE UNITED STATES MIDWAY ATOLL USA	UM
THIBET	CN
THIBET ORIENT	CN
THÜRINGEN	DE
THURSDAY ISLAND	AU
TIANDRE IS	ZZ
TIANDU I	ZZ
TIANDU IS	ZZ
TIBET	CN
TIELT BELGIUM	BE
TIENEN BELGIUM	BE
TIERRA DEL FUEGO	ZZ
TIFTON USA	US
TIHANY HUNGARY	HU
TILIB LUCBAN QUEZON PHILIPPINES	PH
TIM	ID
TIMOR	ZZ
TIMOR ESTE	TL
TIMOR I	ID
TIMOR IS	ID
TIMOR IS NEAR CELEBES	ID
TIMOR LAUT	ID
TIMOR LAUT I	ID
TIMOR LAUT IS TENIMEBER	ID
TIMOR LAUT I TENIMBER	ID
TIMOR LAUT TENIMBER I	ID
TIMOR LAUT TENIMBER IS	ID
TIMOR LESTE	TL
TIMOR LESTE E TIMOR	TL
TIMOR ORIENTAL	TL
TIOGA PENNSYLVANIA UNITED STATES	US
TIREE	GB
TJK	TJ
TKL	TK
TKM	TM
TLS	TL
TNAZANIA	TZ
TOBAGO	TT
TOBAGO BRIT WEST INDIES	TT
TOBAGO BRIT W INDIES	TT
TOBAGO I	TT
TOBAGO IS	TT
TOBAGO ISLAND	TT
TOBAGO ISLE	TT
TOEKAN BESI I	ID
TOEKANG BESI I	ID
TOEKANG BESI IS	ID
TOGO	TG
TOGO GHANA	ZZ
TOGOLAND	TG
TOGO OR GHANA	ZZ
TOGO OR LIBERIA	ZZ
TOGO OR TANZANIA	ZZ
TOGO OU BÉNIN	ZZ
TOGO PROBABLE	TG
TOKELAU	TK
TOKELAU GROUP	TK
TOKELAU GRP	TK
TOKELAU IS	TK
TOKELAU ISLANDS	TK
TOKELAU NEW ZEALAND	ZZ
TOKO	NZ
TOKYO JAPAN	JP
TOMIA I	ID
TON	TO
TOND I	ZZ
TONG	TO
TONGA	TO
TONGA FRIENDLY IS	TO
TONGA GROUP	TO
TONGA GRP	TO
TONGA I	TO
TONGA IS	TO
TONGA I S	TO
TONGA ISLAND	TO
TONGA ISLANDS	TO
TONGA ISS	TO
TONGAN GROUP	TO
TONGAREVA	CK
TONGAREVA ATOLL	CK
TONGAREVA ISLAND	CK
TONGAS	TO
TONGA TONGATAPU	TO
TONKIN	VN
TORHOUT BELGIUM	BE
TORO UGANDA	UG
TORRES ISLANDS	VU
TORRES STRAIT	ZZ
TORTOLA ISLAND	VG
TORTUGAS	ZZ
TOSASHIMIZU KOCHI PREF JAPAN	JP
TOULOUSE FRANCE	FR
TOURAINE FRANCE	FR
TRANCAUCASIA	ZZ
TRANSCASPIA	ZZ
TRANS CASPIA	ZZ
TRANSCAUCASIA	ZZ
TRANS CAUCASIA	ZZ
TRANSCAUCASICA	ZZ
TRANS CAUCASICA	ZZ
TRANSCAUSCASICA	ZZ
TRANSJORDAN	ZZ
TRANSJORDANIA	ZZ
TRANS JORDANIA	ZZ
TRANS JORDONIA	ZZ
TRANSVAAL	ZA
TRANSVAAL PROVINCE	ZA
TRANSYLVANIA	RO
TREBIZOND	TR
TRES MARIAS ISLANDS	MX
TRI	TT
TRIESTE	IT
TRIN	TT
TRINADAD AND TOBAGO	TT
TRINDAD AND TOBAGO	TT
TRINDADE AND MARTIN VAS	TT
TRINDAD TOBAGO	TT
TRINDAD TRINIDA AND TOBAGO	TT
TRING HERTS	GB
TRINIDA	TT
TRINIDAD	TT
TRINIDAD ADN TOBAGO	TT
TRINIDAD ALSO MEXICO	ZZ
TRINIDAD AMP TOBAGO	TT
TRINIDADANDTOBAGO	TT
TRINIDAD AND TOBAGO	TT
TRINIDAD AND TOBAGO TOBAGO	TT
TRINIDAD AND TOBAGO TRINIDAD	TT
TRINIDAD BRITISH WEST INDIES	TT
TRINIDAD B W I	TT
TRINIDAD ET TOBAGO	TT
TRINIDAD I	TT
TRINIDAD IS	TT
TRINIDAD OR TOBAGO	TT
TRINIDAD OR VENEZUELA	ZZ
TRINIDAD S A	TT
TRINÏDAD S A	TT
TRINIDAD SOUTH	TT
TRINIDAD TABAGO	TT
TRINIDAD TOB	TT
TRINIDADTOBAGO	TT
TRINIDAD TOBAGO	TT
TRINIDAD VENEZUELA	ZZ
TRINIDAD WEST INDIES	TT
TRINIDAD Y TOBAGO	TT
TRINITÉ	ZZ
TRINITE ET TOBAGO	TT
TRINITÉ ET TOBAGO	TT
TRIPOLI	LY
TRISTAN DA CUNHA	SH
TRISTAN DA CUNHA I	SH
TRISTANDA CUNHA IS	SH
TRISTAN DA CUNHA ISLAND	SH
TRISTAN DA CUNHA ISLANDS	SH
TRISTAN DA CUNHA ST HELANA	SH
TRISTAN DE CUNHA	SH
TRISTAN DE CUNHA ISLAND	SH
TROBRIAND IS	PG
TROP AMERICA	ZZ
TROPICAL AFRICA	ZZ
TROPICAL AMERICA	ZZ
TROPICAL MEXICO	MX
TRUCIAL STATES	AE
TRURO USA	US
TRUST TERRITORY OF THE PACIFIC CAROLINE ISLANDS	ZZ
TSCHECHIEN	CZ
TSHELA ZAIRE	CD
T T	TT
TTO	TT
TUAMOTO ARCHIPELAGO	PF
TUAMOTO IS	PF
TUAMOTU	PF
TUAMOTUA IS	PF
TUAMOTU ARCH	PF
TUAMOTU ARCHIPELAGO	PF
TUAMOTU GROUP	PF
TUAMOTU I	PF
TUAMOTU IS	PF
TUAMOTU ISL	PF
TUAMOTU ISLAND	PF
TUAMOTU ISLANDS	PF
TUAMOTU ISLES	PF
TUAMOTUS	PF
TUBUAI ISL	PF
TUBUAI ISLANDS	PF
TUBUAIS	PF
TUKAN BESI IS	ID
TUKAN BESSI IS	ID
TUKANG BESI I	ID
TUKANG BESI IS	ID
TUKANG BESI ISL	ID
TUKANG BESSI	ID
TUKONG BESI IS	ID
TUKUYU	TZ
TUKYU	TZ
TULSUYU	ZZ
TUMOR IS	ID
TUN	TN
TUNESIA	TN
TUNESIÃ	TN
TÚNEZ	TN
TUNIS	TN
TUNISEA	TN
TUNISIA	TN
TUNÍSIA	TN
TUNISIA EXTREME S	TN
TUNISIAN REPUBLIC	TN
TUNISIE	TN
TUNISIE OU ALGÉRIE	ZZ
TUNUSIA	TN
TUR	TR
TURCHIA	TR
TURKANA KENYA	KE
TURKEMENISTAN UZBEKISTAN	ZZ
TURKESTAN	ZZ
TURKESTAN EAST TURKESTAN	ZZ
TURKESTAN KAZAKHSTAN	KZ
TURKESTAN UZBEKISTAN	UZ
TURKESTON	ZZ
TURKEY	TR
TURKEY E	TR
TURKEY EUROPE	TR
TURKEY NORTH	TR
TURKEY S	TR
TURKEY TÜRKIYE	TR
TURKISTAN	ZZ
TÜRKIYE	TR
TURKMENIA	TM
TURKMENIST	TM
TURKMENISTAN	TM
TURKMENISTÁN	TM
TURKMÉNISTAN	TM
TURKMENISTAN OR UZBEKISTAN	ZZ
TURKMENISTAN SSR	TM
TURKMENISTAN UZBEKISTAN	ZZ
TURKMENIYA	TM
TURK ORIENT	ZZ
TURKS AND CAICOS	TC
TURKS AND CAICOS BRITISH WEST INDIES	TC
TURKS AND CAICOS IDS	TC
TURKS AND CAICOS ILANDS	TC
TURKS AND CAICOS IS	TC
TURKS AND CAICOS ISLANDS	TC
TURKS AND CIACOS IDS	TC
TURKS CAICOS	TC
TURKS CAICOS BRITISH WEST	TC
TURKS CAICOS IS	TC
TURKS CAICOS ISLANDS	TC
TURKS CAICOS ISLAND S	TC
TURKS ET CAÏCOS ÎLES	TC
TURKS ISLAND	TC
TURKS ISLANDS	TC
TURNHOUT BELGIUM	BE
TURNISIA	TN
TURQUIA	TR
TURQUÍA	TR
TURQUIE	TR
TURQUIE SEPTENTRIONALE	TR
TURRIFF SCOTLAND UK	GB
TURTLE I	ZZ
TUV	TV
TUVALU	TV
TUVALU ELLICE IS	TV
TWN	TW
TX	US
TXAD	TD
TXECA REPÚBLICA	CZ
TYI IS	ZZ
TYROL	AT
TYRRHENIAN SEA MEDITERRANEAN SEA	ZZ
TZA	TZ
TZANEEN NORTHERN PROVINCE SOUTH AFRICA	ZA
U	ZZ
UAE	AE
U A E	AE
UAS	US
UBON RATCHATHANI THAILAND	TH
U BURMA	MM
U COAST OF MADAGASCAR	MG
UCRANIA	UA
UDDEVALLA SWEDEN	SE
UDNY STATION SCOTLAND UK	GB
UGA	UG
UGANAD	UG
UGAND	UG
UGANDA	UG
UGANDA AFRICA	UG
UGANDA AND NORTHERN RHODESIA	ZZ
UGANDA COLONY	UG
UGANDA DEMOCRATIC REPUBLIC OF THE CONGO	ZZ
UGANDA E AFRICA	ZZ
UGANDA EAST AFRICA	UG
UGANDA ITESO	UG
UGANDA KENYA	ZZ
UGANDA OR BEL CONGO	ZZ
UGANDA OR KENYA	ZZ
UGANDA OR ZAMBIA	ZZ
UGANDA SO	UG
UGANDA SUDAN	ZZ
UGANDA ZAIRE	ZZ
UK	GB
U K	GB
UKD	GB
UK ENG	GB
U K ENGLAND	GB
UK ENGLAND	GB
UK ENGLD WAL	GB
UK FALKLAND ISLANDS	FK
UK HKG	HK
UK NO IRELD	GB
UK NORTHERN IRELAND	GB
UKNOWN	ZZ
UKR	UA
UKRA	UA
UKRAINE	UA
UKRAINE MOLDOVA	ZZ
UKRANIAN SSR	UA
UK SCOTLAND	GB
UK WALES	GB
ULU GOMBOK	ZZ
UMEA SWEDEN	SE
UMEÃ SWEDEN	SE
UMI	UM
UNDEFINED	ZZ
UNGARN	HU
UNGAVA	CA
UNIA I	PG
UNIA I BISMARCK ARCHIP	PG
UNION DES COMORES	KM
UNION IS	VC
UNION OF S AFRICA	ZA
UNION OF SOUTH AFRICA	ZA
UNION OF SOVIET SOCIALIST REPUBLICS	ZZ
UNION OF THE COMOROS	KM
UNION SUD AFRICAINE	ZA
UNITED	US
UNITED ARAB EMIRATE	AE
UNITED ARAB EMIRATES	AE
UNITED ARAB REPUBLIC	AE
UNITED KINDOM	GB
UNITEDKINGDOM	GB
UNITED KINGDOM	GB
UNITED KINGDOM CROWN DEPENDENCY	ZZ
UNITED KINGDOM ENGLAND	GB
UNITED KINGDOM NORTHERN IRELAND	GB
UNITED KINGDOM OF GREAT BRITAIN	GB
UNITED KINGDOM OF GREAT BRITAIN AND NORTHERN IRELAND	GB
UNITED KINGDOM OF GREAT BRITAIN AND NORTHERN IRELAND (THE)	GB
UNITED KINGDOM OVERSEAS TERRITORY	ZZ
UNITED KINGDOM SCOTLAND	GB
UNITED KINGDOM UNITED KINGDOM	GB
UNITED KINGDOM UNKNOWN	GB
UNITED KINGDOM WALES	GB
UNITED KINGKOM	GB
UNITED MEXICAN STATES	MX
UNITED REPUBLIC OF TANZANIA	TZ
UNITED STA	US
UNITED STATE	US
UNITEDSTATES	US
UNITED STATES	US
UNITED STATES, ALASKA	US
UNITED STATES AMERICA	US
UNITED STATES CANADA	ZZ
UNITED STATES CAPITIVITY	US
UNITED STATES CAPTIVITY	US
UNITED STATES CENTRAL EASTERN	US
UNITED STATES EASTERN	US
UNITED STATES HAWAII	US
UNITED STATES ILLINOIS MCLEAN COUNTY	US
UNITED STATES IN CAPTIVITY	US
UNITED STATES MEXICO	ZZ
UNITED STATES MINOR OUTLYING ISLANDS	UM
UNITED STATES OF AMEIRCA	US
UNITED STATES OF AMERICA	US
UNITED STATES OF AMERICA ÉTATS UNIS U S A	US
UNITED STATES OF AMERICA OR MEXICO	ZZ
UNITED STATES OF AMERICA U S A	US
UNITED STATES OF AMERICA USA VERENIGDE STATEN ÉTATS UNIS	US
UNITED STATES OF AMERIKA	US
UNITED STATES SEE COMMENTS	US
UNITED STATES U S A	US
UNITED STATES VIRGIN ISLANDS	VI
UNITED STATES WEST COAST	US
UNITED STATES WESTERN	US
UNITED STA UNITED STATES	US
UNITES STATES	US
UNIVERSITY LAKE BATON ROUGE USA	US
UNIVERSITY OF WASHINGTON HATCHERY USA	US
UNIVERSITY OF WISCONSIN USA	US
UNK	ZZ
UNKARI (HU)	HU
UNKNOWN	ZZ
UNKNOWN BRAZIL	BR
UNKNOWN CAPTIVE	ZZ
UNKNOWN COUNTRY	ZZ
UNKNOWN COUNTRY PROBABLY LIBERIA	LR
UNKNOWN LOCALITY	ZZ
UNKNOWN PROB CAPTIVE REARED	ZZ
UNKNOWN PURCH IN HONG KONG	ZZ
UNPLACED	ZZ
UNR	ZZ
UNTD ARAB EM	AE
UNTED STATES CAPTIVITY	US
UNTIED STATES	US
UNYORO	UG
U P	IN
UP ASSAM	IN
UP BURMA	MM
UP BURMA INDIA	ZZ
UP CONGO	ZZ
UP EGYPT	EG
UP GUINEA	GN
U P INDIA	IN
UP MINHO	ZZ
UPPER AMAZONIA	ZZ
UPPER ASSAM	IN
UPPER AUSTRALIA	AU
UPPER AUSTRIA	AT
UPPER BELGIAN CONGO	CD
UPPER BURMA	MM
UPPER CONGO	ZZ
UPPER CONGO F S	CD
UPPER EGYPT	EG
UPPER EQYPT	EG
UPPER NUBIA	SD
UPPER TEBBULAND	CN
UPPER VOLTA	BF
UPPSALA SWEDEN	SE
URAGUAY	UY
URBANA ILLINOIS USA	US
URSS	ZZ
U R S S	ZZ
URUG	UY
URUGUAI	UY
URUGUAY	UY
URUNDI	ZZ
URY	UY
U S	US
USA	US
U S A	US
USA AL	US
USA AND CANADA	ZZ
USA BY INFEREN	US
USA BY INFERENCE	US
USA BY INFERENENCE	US
USA CA	US
U S A CANADA	ZZ
USA CANADA	ZZ
US ADMINISTERED ISLANDS	UM
USADMINISTERED ISLANDS IN THE CENTRAL PACIFIC	UM
USA (EXCEPT ALASKA & HAWAII)	US
USA IN	US
US AL	US
US ALONG RIVER TRAIL	US
U S AMERICA U S A	US
USA MEXICO	ZZ
USA MI	US
USA MO	US
U S A NORTH ATLANTIC OCEAN	US
U S A OR CANADA	ZZ
USA OR CANADA	ZZ
USA OR USSR	ZZ
USA OR WESTERN SAMOA	ZZ
U S A PACIFIC OCEAN	US
USA PROB	US
USA PROBABLY	US
USA WA	US
USBEKISTAN	UZ
USDA	US
USE	ZZ
US GA	US
US LINE ISL	KI
USMARIANAS ISLANDS	MP
US MINOR IS	UM
U S MINOR OUTLYING ISLANDS	UM
US MISC PAC	UM
US MN	US
USSR	ZZ
U S S R	ZZ
U S S R BLACK SEA	ZZ
USSR EUROPEAN PART	ZZ
USSR PRESUMABLY	ZZ
US TRUST TERRITORY	UM
USTRUST TERRITORY	UM
U S TRUST TERRITORY OF THE PACIFIC	ZZ
US TRUST TERRITORY OF THE PACIFIC	UM
USTRUST TERRITORY OF THE PACIFIC	UM
US VA	US
USVI	VI
US VIRGIN IDS	VI
US VIRGIN IS	VI
U S VIRGIN ISLANDS	VI
U S VIRGIN ISLAND S	VI
US VIRGIN ISLANDS	VI
US VIRGIN ISLAND S	VI
USVIRGIN ISLANDS	VI
U S VIRGIN ISLS	VI
UT	US
UTAH	US
UTAH USA	US
UUGANDA	UG
UZB	UZ
UZBEK	UZ
UZBEKISTAN	UZ
UZBEKISTÁN	UZ
UZBEKISTAN SSR	UZ
UZBEKISTAN TURKEMENISTAN	ZZ
VÃLBERG SWEDEN	SE
VALENCIA SPAIN	ES
VALPARAISO	CL
VANCOUVER BRITISH COLUMBIA CANADA	CA
VANCOUVER CANADA	CA
VANTAA FINLAND	FI
VANUA LEVU I	FJ
VANUATA	VU
VANUATU	VU
VANUATU NEWHEBRIDES	VU
VANUATU NEW HEBRIDES	VU
VANUATUNEW HEBRIDES	VU
VANUATU REPUBLIC OF	VU
VANUTAU	VU
VARASANI INDIA	IN
VARIOUS	ZZ
VASTERAS SWEDEN	SE
VÃSTERAS SWEDEN	SE
VAT	VA
VATICAN	VA
VATICAN CITY	VA
VATICAN CITY HOLY SEE	VA
VAUDIGNIES BELGIUM	BE
VÃXJÃ SWEDEN	SE
VÃZON BELGIUM	BE
VCT	VC
VEN	VE
VENÄJÄ (RU)	RU
VENE	VE
VENEÇUELA	VE
VENEGUELA	VE
VENEZ	VE
VENEZELA	VE
VENEZEULA	VE
VENEZ TRINIDAD	ZZ
VENEZUALA	VE
VENEZUELA	VE
V ENEZUELA	VE
VÉNÉZUELA	VE
VÉNÉZUÉLA	VE
VENEZUELA BOLIVARIAN REPUBLIC OF	VE
VENEZUELA COLUMBIA	ZZ
VENEZUELA ECUADOR	ZZ
VENEZUELA GUYANA	ZZ
VENEZUELA N COAST MT	VE
VENEZUELA N COAST MTS	VE
VENEZUELA N COAST M TS	VE
VENEZUELA OR TRINIDAD	ZZ
VENEZUELA RÉPUBLIQUE BOLIVARIENNE DU	VE
VENEZUELA S A	VE
VENEZUÈLA S A	VE
VENEZUELA SURINAM	ZZ
VENEZUELA WEST INDIES	VE
VENEZUELLA	VE
VENICE	IT
VENZUELA	VE
VENZUELA OR TRINIDAD	ZZ
VENZUELEY	VE
VERAGUA	PA
VERAGUA PANAMA	PA
VERAGUE	PA
VERAQUA	PA
VERAQUA PANAMA	PA
VERLAINE BELGIUM	BE
VERMILION ILLINOIS UNITED STATES	US
VERMONT USA	US
VESTFOLD HILLS ANTARCTICA	AQ
VESTFOLD HILLS ANTARTICA	AQ
VEURNE BELGIUM	BE
VGB	VG
VIC	AU
VICTORIA	ZZ
VICTORIA AUSTRALIA	AU
VICTORIA LAND	AQ
VIE	VN
VIERGES I	ZZ
VIET	VN
VIETMAN	VN
VIETNAM	VN
VIET NAM	VN
VIÊTNAM	VN
VIÊT NAM	VN
VIETNAM SOUTH	VN
VIGO SPAIN	ES
VILLAFRANCA NAVARRA SPAIN	ES
VILLAGE DE MOUMPOUTOU LE LONG DE LA RIVIÃRE	CG
VILLEGOUGE GIRONDE FRANCE	FR
VINTON OHIO UNITED STATES	US
VIR	VI
VIRGIN GORDA	VG
VIRGINIA	US
VIRGINIA UNITED STATES	US
VIRGINIA USA	US
VIRGIN IDS	ZZ
VIRGIN IDS BRITISH	VG
VIRGIN IS	ZZ
VIRGIN IS BRIT	VG
VIRGIN ISLANDS	ZZ
VIRGIN ISLANDS BRITISH	VG
VIRGIN ISLANDS OF THE UNITED STATES	VI
VIRGIN ISLANDS ST THOMAS	VI
VIRGIN ISLANDS UK	VG
VIRGIN ISLANDS U K	VG
VIRGIN ISLANDS U K OR U S	ZZ
VIRGIN ISLANDS US	VI
VIRGIN ISLANDS U S	VI
VIRGIN ISLANDS USA	VI
VIRGIN ISLANDS W INDIES	ZZ
VIRGIN IS U S	VI
VIRO (EE)	EE
VITI LEVU I	FJ
VNM	VN
VOGEZEN	FR
VOLCANO I	JP
VOLCANO IS	JP
VOLCANO ISLANDS	ZZ
VOLVIC CLAIRVIC SPRING FRANCE	FR
VOSTOK ISLAND	KI
VPAR VPAR VPAR	ZZ
VPPU	ZZ
VUCTOM I	ZZ
VULCAN IS	JP
VUT	VU
VYLE EN THAROUL BELGIUM	BE
W A	ZZ
WADI NATRUN EGYPT	EG
W AFRICA	ZZ
W AFRICA CAMEROON	CM
W AFRICA GHANA	GH
W AFRICAQ	ZZ
W AFRICA THE GAMBIA SENEGAL	ZZ
WAGENINGEN THE NETHERLANDS	NL
WAIGEOU I	ID
WAIGEU I	ID
WAIGION I	ID
WAIGIOU I	ID
WAIGIU I	ID
WAIGIU IS	ID
WAINGAPO	ID
WAIRAKEI NEW ZEALAND	NZ
WAKAYAMA	JP
WAKE	UM
WAKE ATOLL	UM
WAKE I	UM
WAKE ID	UM
WAKE ISLAND	UM
WAKE ISLANDS	UM
WAKE ISLAND UNITED STATES MINOR OUTLYING ISLANDS	UM
WALES	GB
WALES UK	GB
WALES U K	GB
WALGERIA	DZ
W ALGERIA	DZ
WALLIS AND FUTUNA	WF
WALLIS AND FUTUNA ISLANDS	WF
WALLIS ET FUTUNA	WF
WALLIS FUT I	WF
WALLIS FUTUNA	WF
WALLIS I	WF
WALLIS Y FUTUNA	WF
WALTERS SHOALS	MG
WANGAVA I	FJ
W ANGOLA	AO
W ARABIA	ZZ
WAREGEM BELGIUM	BE
W ARGENTINA	AR
WARREN OHIO UNITED STATES	US
W ARU IS	ID
WARWICK ENGLAND	GB
WARWICK UNIVERSITY UK	GB
WASHINGTON	US
WASHINGTON DC USA	US
WASHINGTON INDIANA UNITED STATES	US
WASHINGTON STATE USA	US
WASHINGTON USA	US
WATFORD UK	GB
W AUSTRALIA	AU
W BELG CONGO	CD
W BOLIVIA	BO
W BORNEO	ZZ
W BRAZIL E PERU E ECUADOR	ZZ
W BRIT SOMALI	SO
W BURU	ID
W BURU I	ID
W BURU IS	ID
W CAMEROON	CM
W CANADA	CA
W CAROLINE IS	ZZ
W CENTRAL AMERICA	ZZ
W CENTR AUSTRALIA	AU
W CENTR CHINA	CN
W CENTR MADAGASCAR	MG
W CEYLON	LK
W CHILE	CL
W CHINA	CN
W CHINA E TIBET	CN
W COAST OF AFRICA GHANA	GH
W COAST OF C AMERICA	ZZ
W COAST OF ECUADOR	EC
W COAST OF GREENLAND	GL
W COAST OF MADAGASCAR	MG
W COAST OF MEXICO	MX
W COAST OF SUMATRA	ID
W COL	CO
W COLOM	CO
W COLOMBIA	CO
W COLUMBIA	CO
W CONGO	ZZ
W CONGO FR ST	CD
W D NEW GUINEA	ID
W D N GUINEA	ID
W DUTCH NEW GUINEA	ID
W ECUADOR	EC
WEDDELL SEA	AQ
W EGYPT	EG
WELLESBOURNE UK	GB
W ERN COL	CO
W ERN PANAMA	PA
W ERN SENEGAL COL	SN
W ERN SENEGAL COLONY	SN
WEST AFRICA	ZZ
WEST AFRICA CAMERUN	CM
WEST AFRICA GABON	GA
WEST AFRICA GAMBIA	GA
WEST AFRICA GAMBIA SENEGAL	ZZ
WEST AFRICA GHANA	GH
WEST AFRICA SENEGAL	SN
WEST AFRICA SOUTH AFRICA	ZZ
WEST AUSTRALIA	AU
WEST AUSTRALIA COAST	AU
WEST BANK	ZZ
WEST BENGAL INDIA	IN
WEST BORNEO	ZZ
WEST BURMA	MM
WEST CAICOS	TC
WEST CAMEROONS	CM
WEST CAROLINE ISLAND	KI
WEST CAROLINE ISLANDS	ZZ
WEST CENTRAL IRAN	IR
WEST CEYLON	LK
WEST CHINA	CN
WEST COAST OF AFRICA	ZZ
WEST COAST OF ECUADOR	EC
WEST COAST OF GREENLAND	GL
WEST COAST OF IRELAND	IE
WEST COAST OF MADAGASCAR	MG
WEST COAST OF N ZEALAND	NZ
WEST COAST OF ST VINCENT B W I	VC
WEST COLOMBIA	CO
WEST ECUADOR	EC
WEST EGYPT	EG
WESTERN AFRICA	ZZ
WESTERN ASIA	ZZ
WESTERN AUSTRALIA	AU
WESTERN BOHEMIA	CZ
WESTERN CANARY ISLANDS	ES
WESTERN CAPRIVI NAMIBIA	NA
WESTERN CHINA	CN
WESTERN COLOMBIA	CO
WESTERN COLUMBIA	CO
WESTERN ECUADOR	EC
WESTERN EUROPE	ZZ
WESTERN GREENLAND	GL
WESTERN HIMALAYAS	ZZ
WESTERN INDIA	IN
WESTERN INDIAN OCEAN	ZZ
WESTERN IRAN	IR
WESTERN IRELAND	IE
WESTERN ITALIAN SOMALILAND	SO
WESTERN JAPAN	JP
WESTERN KENYA	KE
WESTERN MADAGASCAR	MG
WESTERN MALAYSIA	MY
WESTERN MEDITERRANEAN SEA FRANCE	FR
WESTERN MEXICO	MX
WESTERN N AMERICA	ZZ
WESTERN NORTH AMERICA	ZZ
WESTERN PAKISTAN	PK
WESTERN PANAMA	PA
WESTERN SAHARA	EH
WESTERN SAMOA	WS
WESTERN SAMOA PACIFIC OCEAN	WS
WESTERN SENEGAL	SN
WESTERN SENEGAL COLONY	SN
WESTERN SOMOA	WS
WESTERN SPAIN	ES
WESTERN TAIWAN	TW
WESTERN UNITED STATES TO SOUTHERN PERU	ZZ
WESTERN UNITED STATES U S A	US
WESTERN US	US
WESTERN U S	US
WESTERN U S A	US
WEST FALKLAND	FK
WEST FALKLAND ISLANDS	FK
WEST FRICA	ZZ
WEST GERMANY	DE
WEST GERMANY GERMANY	DE
WEST GREENLAND	GL
WEST HIMALAYAS	ZZ
WEST INDIA	IN
WEST INDIAN CRUISE	ZZ
WEST INDIAN OCEAN	ZZ
WEST INDIAN REGION	ZZ
WEST INDIES	ZZ
WEST INDIES ANTIGUA	AG
WEST INDIES ANTIGUA I	AG
WEST INDIES ARUBA I	AW
WEST INDIES BAHAMA IS	BS
WEST INDIES BAHAMAS	BS
WEST INDIES BARBUDA I	AG
WEST INDIES BLANQUILLA I	VE
WEST INDIES BONAIRE I	BQ
WEST INDIES CUBA	CU
WEST INDIES CUBA I	CU
WEST INDIES CURACAO I	CW
WEST INDIES DOMINICA I	DM
WEST INDIES DOMINICA I	DO
WEST INDIES E CUBA	CU
WEST INDIES GRAND CAYMAN	KY
WEST INDIES GRAND CAYMAN I	KY
WEST INDIES GREAT BAHAMA IS	BS
WEST INDIES GRENADA I	GD
WEST INDIES GRENEDA I	GD
WEST INDIES GUADELOUPE	GP
WEST INDIES GUADELOUPE I	GP
WEST INDIES JAMAICA	JM
WEST INDIES LESSER ANT	ZZ
WEST INDIES MARTINIQUE I	MQ
WEST INDIES NORTH SIDE GRAND CAYMAN I	KY
WEST INDIES NORTH SIDE OF GRAND CAYMAN	KY
WEST INDIES PORTO RICO	PR
WEST INDIES PORTO RICO I	PR
WEST INDIES PUERTO RICO	PR
WEST INDIESSAINTTHOMAS	VI
WEST INDIES SAN DOMINGO	DO
WEST INDIES SANTO DOMINGO	DO
WEST INDIES S DOMINGO	DO
WEST INDIES S MAR DE PORTO RICO I	PR
WEST INDIES STA LUCIA I	LC
WEST INDIES ST KITTS	KN
WEST INDIES ST LUCIA I	LC
WEST INDIES ST VINCENT I	VC
WEST INDIES TESTIGOS IS	VE
WEST INDIES TOBAGO	TT
WEST INDIES TOBAGO I	TT
WEST INDIES TOBAGO ISLAND	TT
WEST INDIES TRINIDAD	TT
WEST IRELAND	IE
WEST IRIAN	ID
WEST JAVA	ID
WEST JAVA INDONESIA	ID
WEST KENYA	KE
WESTKERKE BELGIUM	BE
WEST MADAGASCAR	MG
WEST MALAYSIA	MY
WEST MEXICO	MX
WEST NEW GUINEA	ID
WEST OF IRELAND ATLANTIC OCEAN	IE
WEST OF KEY IS	ID
WEST OF PANAMA	PA
WEST OF SCOTLAND	GB
WEST OF SUMATRA	ID
WEST PACIFIC	ZZ
WESTPAKISTAN	PK
WEST PAKISTAN	PK
WEST PAPUA	ID
WEST PAPUA NEW GUINEA	ID
WEST PATAGONIA	ZZ
WEST RUMANIA	RO
WEST RUSSIA	RU
WEST SAHARA	EH
WEST SAMOA	WS
WEST SCOTLAND SEA LOCH	GB
WEST SENEGAL	SN
WEST SIBÉRIA	RU
WEST SUMATRA I	ID
WEST SUMATRA INDONESIA	ID
WEST TIAN SCHAN	CN
WEST VIRGINIA	US
WEST ZAMBIA	ZM
W FALKLAND IS	FK
W FLORES I	ZZ
W GERMANY	DE
W GREENLAND	GL
WHARMINDA SOUTH AUSTRALIA	AU
W HIMALAYA	ZZ
WHITE NILE	ZZ
WHITE SEA	RU
W HUNGARY	HU
WI	US
W I	ZZ
WIAGIOU IS	ZZ
W I BAHAMA	BS
W I BARBADOS	BB
W ICELAND	IS
W I CUBA	CU
W I GUADELOUPE	GP
W I HAITI	HT
W I INDIES	ZZ
W I MARTINIQUE	MQ
WINDHOEK NAMIBIA	NA
W INDIA	IN
W INDIAN OCEAN	ZZ
W INDIAN OCEAN SEYCHELLES	SC
W INDIES	ZZ
W INDIES ANTIGUA	AG
W INDIES ANTIGUA I	AG
W INDIES ANTIQUA	AG
W INDIES ARUBA I	AW
W INDIES BAHAMA IS	BS
W INDIES BAHAMAS I	BS
W INDIES BAHAMAS ISLANDS	BS
W INDIES BARBUDA I	AG
W INDIES BLANQUILLA I	VE
W INDIES BONAIRE I	BQ
W INDIES CUBA	CU
W INDIES CUBA I	CU
W INDIES CURACAO I	CW
W INDIES DOMINICA I	DM
W INDIES DOMINICA I	DO
W INDIES DOMINICA I OR GUADELOUPE I	ZZ
W INDIES E CUBA	CU
W INDIES E CUBA I	CU
W INDIES GRAND CAYMAN I	KY
W INDIES GRAND CAYMAN I NORTH SIDE	KY
W INDIES GUADELOUPE	GP
W INDIES GUADELOUPE I	GP
W INDIES GUADELOUPE IS	GP
W INDIES JAMAICA	JM
W INDIES JAMAICA I	JM
W INDIES LESSER ANTILLES	ZZ
W INDIES MARTINIQUE	MQ
W INDIES MARTINIQUE I	MQ
W INDIES MARTINIQUE I OR MEXICO	ZZ
W INDIES PORTO RICO	PR
W INDIES PORTO RICO I	PR
W INDIES SAN DOMINGO	DO
W INDIES SANTA LUCIA I	LC
W INDIES S DOMINGO	DO
W INDIES STA LUCIA I	LC
W INDIES ST LUCIA I	LC
W INDIES ST MARTIN I	ZZ
W INDIES ST THOMAS I	VI
W INDIES ST VINCENT I	VC
W INDIES ST VINCENT ISLAND	VC
W INDIES TESTIGOS I	VE
W INDIES TESTIGOS ISLES	VE
W INDIES TOBAGO I	TT
W INDIES TOBAGO IS	TT
W INDIES TOBAGO ISLAND	TT
W INDIES TRINIDAD	TT
WINDWARD COAST OF ST VINCENT B W I	VC
WINDWARD ISLANDS	ZZ
WINSLOW NEW ZEALAND	NZ
W I PORTO RICO	PR
W IRELAND	IE
W I SANTO DOMINGO	DO
WISCONSIN	US
WISCONSIN USA	US
WITI ISLAND	ZZ
W I TRINIDAD	TT
WI TRINIDAD TOBAGO	TT
WITU I	PG
WITU I BISMARCK ARCHIP	PG
WITU I N E OF NEW GUINEA	PG
WITU IS	PG
W JAVA	ID
W JAVA I	ID
W KANGEAN	ID
W KENYA	KE
W KENYA COLONY	KE
WLF	WF
W MADAGASCAR	MG
W MALAY PENINS	ZZ
WMALAYSIA	MY
W MARACCO	MA
W MAROCCO	MA
W MEX	MX
W MEXICO	MX
W MONGOLIA	MN
W MOROCCO	MA
W N AMERICA	ZZ
W N AMERICA TO MEXICO HIGLANDS	ZZ
W N BRAZIL N PERU ECUADOR	ZZ
W N E BURMA	MM
W NEPAL	NP
W NEW GUINEA	ID
WNGLAND	GB
W NIGERIA	NG
WNORTHAMERICA	ZZ
W NORTHERN RHODESIA	ZW
W OF BORNEO	ZZ
W OF COLOMBIA	CO
W OF D NEW GUINEA	ID
W OF DU NEW GUINEA	ID
W OF FRENCH SENEGAL	SN
W OF GREENLAND	GL
W OF IRELAND ATLANTIC OCEAN	IE
W OF KEY IS	ID
W OF LOMBLEN IS	ID
W OF MADAGASCAR	MG
W OF MEXICO	MX
W OF MOLUCCA IS	ID
W OF MOLUCCAS	ID
W OF N AMERICA	ZZ
W OF NEW GUINEA	ID
W OF N IRELAND	PG
W OF N MADAGASCAR	MG
W OF NORTH AMERICA	ZZ
W OF PERU	PE
W OF SCOTLAND	GB
W OFSOLOMON IS	SB
W OF SOUTH AFRICA	ZA
W OF SULA IS	ID
W OF SUMATRA	ID
W OF SUMBA	ID
W OF TIMOR IS	ID
W OF W MEXICO	MX
W OF W PANAMA	PA
W OF W SUMATRA	ID
WOMMELGEM BELGIUM	BE
WOODLARK I	PG
WOODS HOLE MASSACHUSETTS USA	US
WORTHING ENGLAND	GB
WOUTH KOREA	KR
W PAKINSTANI	ZZ
W PAKISTAN	PK
W PAKISTANI	PK
W PAKISTAN PAKISTAN	PK
WPALKISTAN	PK
W PANAMA	PA
W PERSIA	ZZ
W PERU	PE
WREXHAM UK	GB
W RUMANIA	RO
W RUSSIA	RU
W SAMOA	WS
W S AUSTRALIA	AU
W S COLOMBIA	CO
W SCOTLAND	GB
W SENEGAL	SN
W SENEGAL COLONY	SN
W SIBERIA	RU
WSM	WS
W SOCIETY IS	PF
W SOMALILAND	SO
W SPAIN	ES
W SUMATRA	ID
W SUMATRA IS	ID
W SUMATRA OR JAVA IS	ID
W SUMBA	ID
W SUMBA I	ID
W SUMBA IS	ID
W SUMBAWA	ID
W SUMBAWA I	ID
W SUMBAWA IS	ID
W TENIMBER IS	ID
W TIANDU I	ID
W TIANDU IS	ID
W TIMOR	ID
W TIMOR I	ID
W TIMOR IS	ID
W TURKESTAN	ZZ
W UGANDA	UG
W U S A	US
W VENEZUELA	VE
W WEST AUSTRALIA	AU
WY	US
WYOMING	US
W YUGO SLAVIA	ZZ
XILE	CL
XILINHOT MONGOLIA CHINA	MN
XINA	CN
XINJIANG CHINA	CN
YAMDENA IS	ID
YANGASA CLUSTER I	FJ
YARAGUAY	PY
YELLOWSTONE NATIONAL PARK WYOMING USA	US
YELLOWSTONE PARK USA	US
YEM	YE
YEMAN	YE
YEMEN	YE
YÉMEN	YE
YEMEN ADEN	YE
YEMEN ARABIA	YE
YEMEN ARAB REPUBLIC	YE
YEMEN NORTHSOUTH	YE
YEMEN S	YE
YEMEN SOUTH	YE
YEMEN SOUTHERN YEMEN	YE
YEMEN THEN ADEN	YE
YIBUTI	DJ
YOLO	US
YOUGOSLAVIE	ZZ
YUCATAN	MX
YUGOSLAVIA	ZZ
YUGO SLAVIA	ZZ
YUGO SLAVIA BOSNIA	BA
YUGOSLAVIA BOSNIA	BA
YUGOSLAVIA CROATIA	HR
YUGO SLAVIA HERCEGOVINA	BA
YUGOSLAVIA HERCEGOVINA	BA
YUGOSLAVIA OR CROATIA OR BOSNIA HERCEGOVINA	ZZ
YUGOSLAVIA OR GREECE	ZZ
YUGOSLOVIA	ZZ
YUNNAN	CN
YVES GOMEZÃE WALCOURT BELGIUM	BE
YVOIR BELGIUM	BE
ZAÃRE	CD
ZAÃRE AUTOUR DU VILLAGE ANDIRI PRÃS DE NDUYE ITURI	CD
ZAÃRE BASCONGO	CD
ZAÃRE ITURI	CD
ZAÃRE ITURI RÃPUBLIQUE DÃMOCRATIQUE DU CONGO	CD
ZAÃRE KATANGA RÃPUBLIQUE DÃMOCRATIQUE DU CONGO	CD
ZAÃRE KISANGANI RÃP DÃMOCRATIQUE DU CONGO	CD
ZAÃRE NDUYE ZONE DE MAMBASA FORÃªT DE LITURI	CD
ZAÃRE ORIENTAL RÃPUBLIQUE DÃMOCRATIQUE DU CONGO	CD
ZAÃRE RÃP DÃMOCRATIQUE DU CONGO	CD
ZAÃRE RÃP DÃMOCRATIQUE DU CONGO CONGO BELGE	CD
ZAÃRE RÃP DÃMOCRATIQUE DU CONGO SUD KIVU	CD
ZAÃRE RÃPUBLIQUE DÃMOCRATIQUE DU CONGO	CD
ZAÃRE SHABA	CD
ZAÃRE SUD KIVU RÃPUBLIQUE DÃMOCRATIQUE DU CONGO	CD
ZAF	ZA
ZAI	CD
ZAIR	CD
ZAIRE	CD
ZAÏRE	CD
ZAIRE BELGIAN CONGO	CD
ZAIRE CONGO	CD
ZAIRE DEMOCRATIC REPUBLIC OF CONGO	CD
ZAIRETETURI FORÃªT DE LITURI	CD
ZAM	ZM
ZAMB	ZM
ZAMBIA	ZM
ZÀMBIA	ZM
ZAMBIA FT	ZM
ZAMBIA NORTHERN	ZM
ZAMBIA NORTHERN RHODESIA	ZZ
ZAMBIA N RHODESIA	ZM
ZAMBIA N RHODESIA	ZZ
ZAMBIA TANZANIA	ZZ
ZAMBIA ZIMBABWE	ZZ
ZAMBIE	ZM
ZANSIBAR	TZ
ZANSIBAR INSEL	TZ
ZANZIBAR	TZ
ZANZIBAR INSEL	TZ
ZANZIBAR SEA LEVEL	TZ
ZÃRICH SWITZERLAND	CH
ZELANDE	NL
ZELE BELGIUM	BE
ZEVEKOTE BELGIUM	BE
ZHEJIANG CHINA	CN
ZIM	ZW
ZIMBABUE	ZW
ZIMBABWE	ZW
ZIMBABWE RHODESIA	ZW
ZIMBABWE SOUTHERN RHODESIA	ZW
ZMB	ZM
ZOERSEL BELGIUM	BE
ZONDEREIGEN BELGIUM	BE
ZOO	ZZ
ZOO AVIARY	ZZ
ZOO CAPTIVE	ZZ
ZOO LAB	ZZ
ZOTTEGEM BELGIUM	BE
ZOUTPANSBERG	ZA
ZR	CD
ZUID PERZIÃ	IR
ZULULAND	ZA
ZULU LAND	ZA
ZWE	ZW
ZWEDEN	SE
ZWEVEGEM BELGIUM	BE
ZWOLLE THE NETHERLANDS	NL
АЗЕРБАЙДЖАН	AZ
АРМЕНИЯ	AM
БЕЛАРУСЬ	BY
ГРУЗИЯ	GE
КАЗАХСТАН	KZ
РОССИЯ	RU
УКРАИНА	UA
